rank;name;old_team;pos;gp;goals;assists;points
1;Evgeni Malkin;PIT;C;75;50;59;109
2;Steven Stamkos;TBL;C;82;60;37;97
3;Claude Giroux;PHI;R;77;28;65;93
4;Jason Spezza;OTT;C;80;34;50;84
5;Ilya Kovalchuk;NJD;L;77;37;46;83
6;Phil Kessel;TOR;R;82;37;45;82
7;James Neal;PIT;L;80;40;41;81
8;John Tavares;NYI;C;82;31;50;81
9;Henrik Sedin;VAN;C;82;14;67;81
10;Patrik Elias;NJD;C;81;26;52;78
11;Erik Karlsson;OTT;D;81;19;59;78
12;Marian Hossa;CHI;R;81;29;48;77
13;Ray Whitney;PHX;L;82;24;53;77
14;Joe Thornton;SJS;C;82;18;59;77
15;Marian Gaborik;NYR;R;82;41;35;76
16;Jordan Eberle;EDM;R;78;34;42;76
17;Anze Kopitar;LAK;C;82;25;51;76
18;Martin St Louis;TBL;R;77;25;49;74
19;Jason Pominville;BUF;R;82;30;43;73
20;Loui Eriksson;DAL;L;82;26;45;71
21;Eric Staal;CAR;C;82;24;46;70
22;Matt Moulson;NYI;L;82;36;33;69
23;Patrick Sharp;CHI;L;74;33;36;69
24;Zach Parise;NJD;L;82;31;38;69
25;Henrik Zetterberg;DET;L;82;22;47;69
26;Scott Hartnell;PHI;L;82;37;30;67
27;Jarome Iginla;CGY;R;82;32;35;67
28;Daniel Sedin;VAN;L;72;30;37;67
29;Tyler Seguin;BOS;C;81;29;38;67
30;Joffrey Lupul;TOR;L;66;25;42;67
31;Pavel Datsyuk;DET;C;70;19;48;67
32;PA Parenteau;NYI;R;80;18;49;67
33;Teemu Selanne;ANA;R;82;26;40;66
34;Brad Richards;NYR;C;82;25;41;66
35;Patrick Kane;CHI;R;82;23;43;66
36;Valtteri Filppula;DET;C;81;23;43;66
37;Alex Ovechkin;WSH;L;78;38;27;65
38;Max Pacioretty;MTL;L;79;33;32;65
39;Logan Couture;SJS;C;80;31;34;65
40;Teddy Purcell;TBL;R;81;24;41;65
41;Patrick Marleau;SJS;L;82;30;34;64
42;Patrice Bergeron;BOS;C;81;22;42;64
43;Blake Wheeler;WPG;R;80;17;47;64
44;Jamie Benn;DAL;L;71;26;37;63
45;Mike Ribeiro;DAL;C;74;18;45;63
46;Radim Vrbata;PHX;R;77;35;27;62
47;Michael Ryder;DAL;R;82;35;27;62
48;David Krejci;BOS;C;79;23;39;62
49;Erik Cole;MTL;L;82;35;26;61
50;Joe Pavelski;SJS;C;82;31;30;61
51;Tomas Fleischmann;FLA;L;82;27;34;61
52;Chris Kunitz;PIT;L;82;26;35;61
53;Milan Lucic;BOS;L;81;26;35;61
54;Thomas Vanek;BUF;L;78;26;35;61
55;Olli Jokinen;CGY;C;82;23;38;61
56;Corey Perry;ANA;R;80;37;23;60
57;Milan Michalek;OTT;L;77;35;25;60
58;David Desharnais;MTL;C;81;16;44;60
59;Rick Nash;CBJ;L;82;30;29;59
60;Daniel Alfredsson;OTT;R;75;27;32;59
61;Pascal Dupuis;PIT;R;82;25;34;59
62;Justin Williams;LAK;R;82;22;37;59
63;Martin Erat;NSH;R;71;19;39;58
64;Bobby Ryan;ANA;R;82;31;26;57
65;Evander Kane;WPG;L;74;30;27;57
66;Jonathan Toews;CHI;C;59;29;28;57
67;Stephen Weiss;FLA;C;80;20;37;57
68;Ryan Getzlaf;ANA;C;82;11;46;57
69;Johan Franzen;DET;R;77;29;27;56
70;Brad Marchand;BOS;L;76;28;27;55
71;Ryan O'Reilly;COL;C;81;18;37;55
72;Vinny Prospal;CBJ;L;82;16;39;55
73;Ryan Callahan;NYR;R;76;29;25;54
74;David Backes;STL;C;82;24;30;54
75;Kris Versteeg;FLA;R;71;23;31;54
76;Dustin Brown;LAK;R;82;22;32;54
77;Alexander Semin;WSH;R;77;21;33;54
78;T.J. Oshie;STL;R;80;19;35;54
79;Jaromir Jagr;PHI;R;73;19;35;54
80;Taylor Hall;EDM;L;61;27;26;53
81;Dany Heatley;MIN;L;82;24;29;53
82;Paul Stastny;COL;C;79;21;32;53
83;David Legwand;NSH;C;78;19;34;53
84;Dustin Byfuglien;WPG;D;66;12;41;53
85;Brian Campbell;FLA;D;82;4;49;53
86;Alexandre Burrows;VAN;L;80;28;24;52
87;Gabriel Landeskog;COL;L;82;22;30;52
88;Ryan Nugent-Hopkins;EDM;C;62;18;34;52
89;Tomas Plekanec;MTL;C;81;17;35;52
90;Zdeno Chara;BOS;D;79;12;40;52
91;Mike Fisher;NSH;C;72;24;27;51
92;Mikhail Grabovski;TOR;C;74;23;28;51
93;Derek Stepan;NYR;C;82;17;34;51
94;Adam Henrique;NJD;C;74;16;35;51
95;Alex Pietrangelo;STL;D;81;12;39;51
96;Andrew Ladd;WPG;L;82;28;22;50
97;Jiri Hudler;DET;C;81;25;25;50
98;Jordan Staal;PIT;C;62;25;25;50
99;Shane Doan;PHX;R;79;22;28;50
100;Drew Stafford;BUF;R;80;20;30;50
101;Wayne Simmonds;PHI;R;82;28;21;49
102;Ryan Kesler;VAN;C;77;22;27;49
103;Vincent Lecavalier;TBL;C;64;22;27;49
104;Shea Weber;NSH;D;78;19;30;49
105;Jakub Voracek;PHI;R;78;18;31;49
106;Danny Briere;PHI;R;70;16;33;49
107;Alex Tanguay;CGY;L;64;13;36;49
108;Alexander Edler;VAN;D;82;11;38;49
109;Curtis Glencross;CGY;L;67;26;22;48
110;Ryan Malone;TBL;L;68;20;28;48
111;Steve Sullivan;PIT;L;79;17;31;48
112;Dan Boyle;SJS;D;81;9;39;48
113;Matt Read;PHI;R;79;24;23;47
114;Tyler Bozak;TOR;C;73;18;29;47
115;Sam Gagner;EDM;C;75;18;29;47
116;Kyle Wellwood;WPG;C;77;18;29;47
117;Frans Nielsen;NYI;C;82;17;30;47
118;Nick Foligno;OTT;L;82;15;32;47
119;Mark Streit;NYI;D;82;7;40;47
120;David Clarkson;NJD;R;80;30;16;46
121;Bryan Little;WPG;C;74;24;22;46
122;Ryan Smyth;EDM;L;82;19;27;46
123;Marcus Johansson;WSH;C;80;14;32;46
124;Jussi Jokinen;CAR;L;79;12;34;46
125;Dennis Wideman;WSH;D;82;11;35;46
126;Ryan Suter;NSH;D;79;7;39;46
127;Kyle Okposo;NYI;R;79;24;21;45
128;Ryane Clowe;SJS;L;76;17;28;45
129;Kyle Brodziak;MIN;C;82;22;22;44
130;Petr Sykora;NJD;R;82;21;23;44
131;Jeff Skinner;CAR;C;64;20;24;44
132;Mike Richards;LAK;C;74;18;26;44
133;Derek Roy;BUF;C;80;17;27;44
134;Dainius Zubrus;NJD;R;82;17;27;44
135;Nicklas Backstrom;WSH;C;42;14;30;44
136;Dion Phaneuf;TOR;D;82;12;32;44
137;Mikko Koivu;MIN;C;55;12;32;44
138;Kevin Bieksa;VAN;D;78;8;36;44
139;Patric Hornqvist;NSH;R;76;27;16;43
140;Viktor Stalberg;CHI;R;79;22;21;43
141;Clarke MacArthur;TOR;L;73;20;23;43
142;Chris Higgins;VAN;L;71;18;25;43
143;Sergei Kostitsyn;NSH;L;75;17;26;43
144;Keith Yandle;PHX;D;82;11;32;43
145;Kevin Shattenkirk;STL;D;81;9;34;43
146;Kimmo Timonen;PHI;D;76;4;39;43
147;David Perron;STL;L;57;21;21;42
148;Rich Peverley;BOS;C;57;11;31;42
149;Kris Letang;PIT;D;51;10;32;42
150;Mike Cammalleri;MTL, CGY;C;66;20;21;41
151;Cody Hodgson;VAN, BUF;C;83;19;22;41
152;Brooks Laich;WSH;C;82;16;25;41
153;Derick Brassard;CBJ;C;74;14;27;41
154;Steve Downie;TBL, COL;R;75;14;27;41
155;Michael Del Zotto;NYR;D;77;10;31;41
156;RJ Umberger;CBJ;L;77;20;20;40
157;Duncan Keith;CHI;D;74;4;36;40
158;Chris Kelly;BOS;C;82;20;19;39
159;Jason Chimera;WSH;L;82;20;19;39
160;Jannik Hansen;VAN;R;82;16;23;39
161;Steve Ott;DAL;C;74;11;28;39
162;Patrik Berglund;STL;C;82;19;19;38
163;Matt Cooke;PIT;L;82;19;19;38
164;Todd Bertuzzi;DET;R;71;14;24;38
165;Carl Hagelin;NYR;L;64;14;24;38
166;Jack Johnson;LAK, CBJ;D;82;12;26;38
167;Saku Koivu;ANA;C;74;11;27;38
168;Matthew Carle;PHI;D;82;4;34;38
169;David Jones;COL;R;72;20;17;37
170;Jamie McGinn;SJS, COL;L;78;20;17;37
171;Dave Bolland;CHI;C;76;19;18;37
172;Lauri Korpikoski;PHX;L;82;17;20;37
173;Colin Greening;OTT;L;82;17;20;37
174;Milan Hejduk;COL;R;81;14;23;37
175;Brent Burns;SJS;D;81;11;26;37
176;Antoine Vermette;CBJ, PHX;C;82;11;26;37
177;Sidney Crosby;PIT;C;22;8;29;37
178;Sergei Gonchar;OTT;D;74;5;32;37
179;Dan Hamhuis;VAN;D;82;4;33;37
180;Nick Leddy;CHI;D;82;3;34;37
181;Devin Setoguchi;MIN;R;69;19;17;36
182;Jiri Tlusty;CAR;C;79;17;19;36
183;Artem Anisimov;NYR;C;79;16;20;36
184;Andrei Kostitsyn;MTL, NSH;L;72;16;20;36
185;Niklas Kronwall;DET;D;82;15;21;36
186;Craig Smith;NSH;C;72;14;22;36
187;Tim Connolly;TOR;C;70;13;23;36
188;Drew Doughty;LAK;D;77;10;26;36
189;Ales Hemsky;EDM;R;69;10;26;36
190;P.K. Subban;MTL;D;81;7;29;36
191;Nik Antropov;WPG;C;69;15;20;35
192;Colin Wilson;NSH;C;68;15;20;35
193;Matt Cullen;MIN;C;73;14;21;35
194;Jeff Carter;CBJ, LAK;C;55;21;13;34
195;Maxime Talbot;PHI;C;81;19;15;34
196;Tuomo Ruutu;CAR;C;72;18;16;34
197;Jason Arnott;STL;C;72;17;17;34
198;Tyler Ennis;BUF;L;48;15;19;34
199;Shawn Horcoff;EDM;C;81;13;21;34
200;Nicklas Lidstrom;DET;D;70;11;23;34
201;Brandon Dubinsky;NYR;C;77;10;24;34
202;Brent Seabrook;CHI;D;78;9;25;34
203;Martin Hanzal;PHX;C;64;8;26;34
204;Troy Brouwer;WSH;R;82;18;15;33
205;Ryan Jones;EDM;L;79;17;16;33
206;Jason Garrison;FLA;D;77;16;17;33
207;Alexei Ponikarovsky;CAR, NJD;L;82;14;19;33
208;Daniel Cleary;DET;R;75;12;21;33
209;Tyler Kennedy;PIT;C;60;11;22;33
210;Tobias Enstrom;WPG;D;62;6;27;33
211;Michael Grabner;NYI;R;78;20;12;32
212;Chad LaRose;CAR;R;67;19;13;32
213;Brandon Sutter;CAR;C;82;17;15;32
214;Nathan Horton;BOS;R;46;17;15;32
215;Benoit Pouliot;BOS;L;74;16;16;32
216;Oliver Ekman-Larsson;PHX;D;82;13;19;32
217;Josh Bailey;NYI;C;80;13;19;32
218;Tomas Kopecky;FLA;R;80;10;22;32
219;John Carlson;WSH;D;82;9;23;32
220;Ryan McDonagh;NYR;D;82;7;25;32
221;Ian White;DET;D;77;7;25;32
222;Nikita Nikitin;STL, CBJ;D;61;7;25;32
223;Filip Kuba;OTT;D;73;6;26;32
224;Christian Ehrhoff;BUF;D;66;5;27;32
225;Mikael Samuelsson;VAN, FLA;R;54;14;17;31
226;Tomas Kaberle;CAR, MTL;D;72;3;28;31
227;David Booth;FLA, VAN;L;62;16;14;30
228;Mathieu Perreault;WSH;C;64;16;14;30
229;Chris Stewart;STL;R;79;15;15;30
230;Daymond Langkow;PHX;C;73;11;19;30
231;Alex Goligoski;DAL;D;71;9;21;30
232;Jake Gardiner;TOR;D;75;7;23;30
233;Jordin Tootoo;NSH;R;77;6;24;30
234;Zach Bogosian;WPG;D;65;5;25;30
235;Kyle Turris;PHX, OTT;C;55;12;17;29
236;Dan Girardi;NYR;D;82;5;24;29
237;Jay Bouwmeester;CGY;D;82;5;24;29
238;Cam Fowler;ANA;D;82;5;24;29
239;Lars Eller;MTL;C;79;16;12;28
240;Alexander Steen;STL;L;43;15;13;28
241;Matt Halischuk;NSH;R;73;15;13;28
242;Lee Stempniak;CGY;R;61;14;14;28
243;Matt Duchene;COL;C;58;14;14;28
244;Alexander Burmistrov;WPG;C;76;13;15;28
245;Chris Neil;OTT;R;72;13;15;28
246;Nikolai Kulemin;TOR;L;70;7;21;28
247;Dmitry Kulikov;FLA;D;58;4;24;28
248;Cal Clutterbuck;MIN;R;74;15;12;27
249;Sean Couturier;PHI;C;77;13;14;27
250;Andrew Brunette;CHI;L;78;12;15;27
251;Marcel Goc;FLA;C;57;11;16;27
252;Tim Stapleton;WPG;R;63;11;16;27
253;Mark Giordano;CGY;D;61;9;18;27
254;Jamie McBain;CAR;D;76;8;19;27
255;John-Michael Liles;TOR;D;66;7;20;27
256;Martin Havlat;SJS;R;39;7;20;27
257;Lubomir Visnovsky;ANA;D;68;6;21;27
258;James Wisniewski;CBJ;D;48;6;21;27
259;Paul Martin;PIT;D;73;2;25;27
260;Raffi Torres;PHX;L;79;15;11;26
261;Zack Smith;OTT;C;81;14;12;26
262;Andrew Cogliano;ANA;C;82;13;13;26
263;Brian Boyle;NYR;C;82;11;15;26
264;Brenden Morrow;DAL;L;57;11;15;26
265;Joey Crabb;TOR;R;67;11;15;26
266;Marcus Kruger;CHI;C;71;9;17;26
267;Darren Helm;DET;C;68;9;17;26
268;Nick Johnson;MIN;R;77;8;18;26
269;Kyle Quincey;COL, DET;D;72;7;19;26
270;Fedor Tyutin;CBJ;D;66;5;21;26
271;Erik Johnson;COL;D;73;4;22;26
272;Drew Miller;DET;L;80;14;11;25
273;Mark Letestu;PIT, CBJ;C;62;11;14;25
274;Sami Salo;VAN;D;69;9;16;25
275;Erik Condra;OTT;R;81;8;17;25
276;Ville Leino;BUF;C;71;8;17;25
277;Andrej Meszaros;PHI;D;62;7;18;25
278;Nathan Gerbe;BUF;L;62;6;19;25
279;Trevor Daley;DAL;D;79;4;21;25
280;Joe Corvo;BOS;D;75;4;21;25
281;Dominic Moore;TBL, SJS;C;79;4;21;25
282;Jeff Petry;EDM;D;73;2;23;25
283;Rene Bourque;CGY, MTL;R;76;18;6;24
284;Tim Brent;CAR;C;79;12;12;24
285;Mikkel Boedker;PHX;L;82;11;13;24
286;Tomas Holmstrom;DET;L;74;11;13;24
287;James van Riemsdyk;PHI;L;43;11;13;24
288;Jordan Leopold;BUF;D;79;10;14;24
289;Shawn Matthias;FLA;C;79;10;14;24
290;Bryan Bickell;CHI;L;71;9;15;24
291;Brian Rolston;NYI, BOS;R;70;7;17;24
292;Michal Handzus;SJS;C;67;7;17;24
293;Andrew Ference;BOS;D;72;6;18;24
294;Jamie Langenbrunner;STL;R;70;6;18;24
295;Willie Mitchell;LAK;D;76;5;19;24
296;Luca Sbisa;ANA;D;80;5;19;24
297;Braydon Coburn;PHI;D;81;4;20;24
298;Marc-Andre Bergeron;TBL;D;43;4;20;24
299;Travis Hamonic;NYI;D;73;2;22;24
300;Sean Bergenheim;FLA;L;62;17;6;23
301;Andrew Shaw;CHI;R;37;12;11;23
302;Jay Harrison;CAR;D;72;9;14;23
303;Niklas Hagman;CGY, ANA;L;71;9;14;23
304;Daniel Winnik;COL, SJS;C;84;8;15;23
305;Tyler Myers;BUF;D;55;8;15;23
306;Boyd Gordon;PHX;C;75;8;15;23
307;Brad Boyes;BUF;R;65;8;15;23
308;Dennis Seidenberg;BOS;D;80;5;18;23
309;Victor Hedman;TBL;D;61;5;18;23
310;Marc-Edouard Vlasic;SJS;D;82;4;19;23
311;Jared Spurgeon;MIN;D;70;3;20;23
312;Nick Spaling;NSH;L;77;10;12;22
313;Andy McDonald;STL;L;25;10;12;22
314;Pierre-Marc Bouchard;MIN;C;37;9;13;22
315;Francois Beauchemin;ANA;D;82;8;14;22
316;Justin Faulk;CAR;D;66;8;14;22
317;Justin Abdelkader;DET;L;81;8;14;22
318;Stephane Robidas;DAL;D;75;5;17;22
319;Tom Gilbert;EDM, MIN;D;67;3;19;22
320;Marek Zidlicky;MIN, NJD;D;63;2;20;22
321;Luke Schenn;TOR;D;79;2;20;22
322;Eric Nystrom;DAL;L;74;16;5;21
323;Jim Slater;WPG;C;78;13;8;21
324;Ryan Johansen;CBJ;C;67;9;12;21
325;Vernon Fiddler;DAL;C;82;8;13;21
326;Paul Gaustad;BUF, NSH;C;70;7;14;21
327;Brad Stuart;DET;D;81;6;15;21
328;Sheldon Souray;DAL;D;64;6;15;21
329;Jarret Stoll;LAK;C;78;6;15;21
330;Cody Franson;TOR;D;57;5;16;21
331;Matt Niskanen;PIT;D;75;4;17;21
332;Kevin Klein;NSH;D;66;4;17;21
333;Corey Potter;EDM;D;62;4;17;21
334;Radek Dvorak;DAL;R;73;4;17;21
335;Eric Brewer;TBL;D;82;1;20;21
336;Ryan Wilson;COL;D;59;1;20;21
337;Derek Dorsett;CBJ;R;77;12;8;20
338;Mason Raymond;VAN;L;55;10;10;20
339;Luke Adam;BUF;C;52;10;10;20
340;Ruslan Fedotenko;NYR;L;73;9;11;20
341;Anthony Stewart;CAR;R;77;9;11;20
342;Slava Voynov;LAK;D;54;8;12;20
343;Vladimir Sobotka;STL;L;73;5;15;20
344;Shane O'Brien;COL;D;76;3;17;20
345;Matt Gilroy;TBL, OTT;D;67;3;17;20
346;Ryan Whitney;EDM;D;51;3;17;20
347;Tom Pyatt;TBL;C;74;12;7;19
348;Torrey Mitchell;SJS;C;76;9;10;19
349;Maxim Lapierre;VAN;C;82;9;10;19
350;Taylor Pyatt;PHX;L;73;9;10;19
351;Gabriel Bourque;NSH;L;43;7;12;19
352;Adam Burish;DAL;R;65;6;13;19
353;Andrew MacDonald;NYI;D;75;5;14;19
354;Jan Hejda;COL;D;81;5;14;19
355;Chris Phillips;OTT;D;80;5;14;19
356;Carl Gunnarsson;TOR;D;76;4;15;19
357;Dmitry Orlov;WSH;D;60;3;16;19
358;Carlo Colaiacovo;STL;D;64;2;17;19
359;Brayden Schenn;PHI;C;54;12;6;18
360;Matt D'Agostini;STL;R;55;9;9;18
361;Matthew Lombardi;TOR;C;62;8;10;18
362;Matt Stajan;CGY;C;61;8;10;18
363;Manny Malhotra;VAN;C;78;7;11;18
364;Mike Knuble;WSH;R;72;6;12;18
365;Joel Ward;WSH;R;73;6;12;18
366;Craig Adams;PIT;R;82;5;13;18
367;Nick Bonino;ANA;C;50;5;13;18
368;Yannick Weber;MTL;D;60;4;14;18
369;Johnny Oduya;WPG, CHI;D;81;3;15;18
370;Brooks Orpik;PIT;D;73;2;16;18
371;Adam Larsson;NJD;D;65;2;16;18
372;Anton Stralman;NYR;D;53;2;16;18
373;Tim Gleason;CAR;D;82;1;17;18
374;Jay McClement;COL;C;80;10;7;17
375;Dustin Penner;LAK;R;65;7;10;17
376;Simon Gagne;LAK;L;34;7;10;17
377;Jared Cowen;OTT;D;82;5;12;17
378;Brandon Prust;NYR;L;82;5;12;17
379;Joni Pitkanen;CAR;D;30;5;12;17
380;Mark Fayne;NJD;D;82;4;13;17
381;Samuel Pahlsson;CBJ, VAN;C;80;4;13;17
382;Deryk Engelland;PIT;D;73;4;13;17
383;Grant Clitsome;CBJ, WPG;D;63;4;13;17
384;Andrew Desjardins;SJS;C;76;4;13;17
385;Karl Alzner;WSH;D;82;1;16;17
386;Travis Moen;MTL;L;48;9;7;16
387;Gregory Campbell;BOS;C;78;8;8;16
388;Peter Mueller;COL;C;32;7;9;16
389;Bobby Butler;OTT;R;56;6;10;16
390;Tanner Glass;WPG;L;78;5;11;16
391;Roman Josi;NSH;D;52;5;11;16
392;John Mitchell;NYR;C;63;5;11;16
393;Arron Asham;PIT;R;64;5;11;16
394;Eric Belanger;EDM;C;78;4;12;16
395;Jeff Halpern;WSH;C;69;4;12;16
396;Raphael Diaz;MTL;D;59;3;13;16
397;Aaron Johnson;CBJ;D;56;3;13;16
398;Kyle Chipchura;PHX;C;53;3;13;16
399;Josh Gorges;MTL;D;82;2;14;16
400;Andy Greene;NJD;D;56;1;15;16
401;Brian Lee;OTT, TBL;D;55;1;15;16
402;Mike Weaver;FLA;D;82;0;16;16
403;Nate Thompson;TBL;C;68;9;6;15
404;TJ Galiardi;COL, SJS;L;69;9;6;15
405;Daniel Paille;BOS;L;69;9;6;15
406;Matt Frattin;TOR;R;56;8;7;15
407;Brian Gionta;MTL;R;31;8;7;15
408;Jordan Caron;BOS;R;48;7;8;15
409;Jamal Mayers;CHI;R;81;6;9;15
410;Tom Wandell;DAL;C;72;6;9;15
411;Ladislav Smid;EDM;D;78;5;10;15
412;Johnny Boychuk;BOS;D;77;5;10;15
413;Blake Comeau;NYI, CGY;L;74;5;10;15
414;Michael Frolik;CHI;R;63;5;10;15
415;Jaroslav Spacek;MTL, CAR;D;46;5;10;15
416;Matt Greene;LAK;D;82;4;11;15
417;Brett Connolly;TBL;R;68;4;11;15
418;Matt Beleskey;ANA;L;70;4;11;15
419;Pavel Kubina;TBL, PHI;D;69;3;12;15
420;Brett Clark;TBL;D;82;2;13;15
421;Chris Butler;CGY;D;68;2;13;15
422;Marc-Andre Gragnani;BUF, VAN;D;58;2;13;15
423;Niklas Hjalmarsson;CHI;D;69;1;14;15
424;Matt Martin;NYI;L;80;7;7;14
425;Derek MacKenzie;CBJ;C;66;7;7;14
426;Chuck Kobasew;COL;R;58;7;7;14
427;Richard Park;PIT;R;54;7;7;14
428;Cam Atkinson;CBJ;R;27;7;7;14
429;Steve Montador;CHI;D;52;5;9;14
430;Dwight King;LAK;L;27;5;9;14
431;Gilbert Brule;PHX;C;33;5;9;14
432;Kurtis Foster;ANA, NJD, MIN;D;51;4;10;14
433;Joe Vitale;PIT;C;68;4;10;14
434;Mark Stuart;WPG;D;80;3;11;14
435;Sheldon Brookbank;ANA;D;80;3;11;14
436;TJ Brodie;CGY;D;54;2;12;14
437;Bryan Allen;CAR;D;82;1;13;14
438;David Steckel;TOR;C;76;8;5;13
439;Ben Eager;EDM;L;63;8;5;13
440;Devante Smith-Pelly;ANA;R;49;7;6;13
441;Darroll Powe;MIN;C;82;6;7;13
442;Bruno Gervais;TBL;D;50;6;7;13
443;Drayson Bowman;CAR;L;37;6;7;13
444;Marcus Foligno;BUF;L;14;6;7;13
445;Shawn Thornton;BOS;L;81;5;8;13
446;Antti Miettinen;WPG;R;45;5;8;13
447;Jason Demers;SJS;D;57;4;9;13
448;Stefan Elliott;COL;D;39;4;9;13
449;Andrej Sekera;BUF;D;69;3;10;13
450;Rostislav Klesla;PHX;D;65;3;10;13
451;Ed Jovanovski;FLA;D;66;3;10;13
452;Zbynek Michalek;PIT;D;62;2;11;13
453;Roman Hamrlik;WSH;D;68;2;11;13
454;Barret Jackman;STL;D;81;1;12;13
455;Hal Gill;MTL, NSH;D;76;1;12;13
456;Michal Rozsival;PHX;D;54;1;12;13
457;Jakub Kindl;DET;D;55;1;12;13
458;Toni Lydman;ANA;D;74;0;13;13
459;Jason Blake;ANA;L;45;7;5;12
460;Erik Christensen;NYR, MIN;C;49;7;5;12
461;Kris Russell;CBJ, STL;D;55;6;6;12
462;Alec Martinez;LAK;D;51;6;6;12
463;Patrick Dwyer;CAR;R;73;5;7;12
464;Kyle Clifford;LAK;L;81;5;7;12
465;Mathieu Darche;MTL;L;61;5;7;12
466;Tom Kostopoulos;CGY;R;81;4;8;12
467;Ryan Shannon;TBL;R;45;4;8;12
468;Wojtek Wolski;NYR, FLA;L;31;4;8;12
469;Marco Scandella;MIN;D;63;3;9;12
470;Scott Hannan;CGY;D;78;2;10;12
471;Nate Prosser;MIN;D;51;1;11;12
472;Chris Pronger;PHI;D;13;1;11;12
473;Mike Santorelli;FLA;C;60;9;2;11
474;Cody McLeod;COL;L;75;6;5;11
475;Kaspars Daugavins;OTT;L;65;5;6;11
476;Francis Bouillon;NSH;D;66;4;7;11
477;Chris Thorburn;WPG;R;72;4;7;11
478;Mikael Backlund;CGY;C;41;4;7;11
479;Brendan Morrison;CGY, CHI;C;39;4;7;11
480;Milan Jurcina;NYI;D;65;3;8;11
481;Philip Larsen;DAL;D;55;3;8;11
482;Roman Horak;CGY;C;61;3;8;11
483;Ryan Ellis;NSH;D;32;3;8;11
484;Keith Aucoin;WSH;C;27;3;8;11
485;Anton Volchenkov;NJD;D;72;2;9;11
486;Derek Morris;PHX;D;59;2;9;11
487;Justin Braun;SJS;D;66;2;9;11
488;Derek Smith;CGY;D;47;2;9;11
489;Chris Campoli;MTL;D;43;2;9;11
490;Scott Gomez;MTL;C;38;2;9;11
491;JT Wyman;TBL;R;40;2;9;11
492;Daniel Carcillo;CHI;L;28;2;9;11
493;Jonathan Ericsson;DET;D;69;1;10;11
494;David Schlemko;PHX;D;46;1;10;11
495;Roman Polak;STL;D;77;0;11;11
496;Nicklas Grossmann;DAL, PHI;D;74;0;11;11
497;Cory Emmerton;DET;C;71;6;4;10
498;Brad Winchester;SJS;L;67;6;4;10
499;Patrick Kaleta;BUF;R;63;5;5;10
500;Louis Leblanc;MTL;C;42;5;5;10
501;Aaron Rome;VAN;D;43;4;6;10
502;Jack Skille;FLA;R;46;4;6;10
503;Zack Kassian;BUF, VAN;R;44;4;6;10
504;Tomas Vincour;DAL;C;47;4;6;10
505;Andy Sutton;EDM;D;52;3;7;10
506;Adam McQuaid;BOS;D;72;2;8;10
507;David Savard;CBJ;D;31;2;8;10
508;Anton Babchuk;CGY;D;32;2;8;10
509;Ron Hainsey;WPG;D;56;0;10;10
510;Jimmy Hayes;CHI;R;31;5;4;9
511;Eric Wellwood;PHI;L;24;5;4;9
512;Guillaume Latendresse;MIN;L;16;5;4;9
513;Matt Hendricks;WSH;C;78;4;5;9
514;Lennart Petrell;EDM;L;60;4;5;9
515;Alexander Sulzer;VAN, BUF;D;27;3;6;9
516;Tommy Wingels;SJS;C;33;3;6;9
517;Tim Wallace;NYI, TBL;R;49;3;6;9
518;Adrian Aucoin;PHX;D;64;2;7;9
519;Jacob Josefson;NJD;C;41;2;7;9
520;Zac Rinaldo;PHI;C;66;2;7;9
521;David Moss;CGY;R;32;2;7;9
522;Spencer Machacek;WPG;R;13;2;7;9
523;Rob Scuderi;LAK;D;82;1;8;9
524;Justin Falk;MIN;D;47;1;8;9
525;Bryce Salvador;NJD;D;82;0;9;9
526;Stu Bickel;NYR;D;51;0;9;9
527;Benn Ferriero;SJS;R;35;7;1;8
528;Brad Richardson;LAK;C;59;5;3;8
529;Ryan Carter;FLA, NJD;C;72;4;4;8
530;Dale Weise;VAN;R;68;4;4;8
531;Jochen Hecht;BUF;C;22;4;4;8
532;David Ullstrom;NYI;L;29;4;4;8
533;Cody Eakin;WSH;C;30;4;4;8
534;Greg Zanon;MIN, BOS;D;56;3;5;8
535;Scott Nichol;STL;C;80;3;5;8
536;Andreas Nodl;PHI, CAR;R;60;3;5;8
537;Matt Ellis;BUF;L;60;3;5;8
538;Matt Bradley;FLA;R;45;3;5;8
539;Blair Jones;TBL, CGY;C;43;3;5;8
540;Corey Tropp;BUF;R;34;3;5;8
541;Erik Gudbranson;FLA;D;72;2;6;8
542;Colton Gillies;MIN, CBJ;C;75;2;6;8
543;Colin Fraser;LAK;C;67;2;6;8
544;Magnus Paajarvi;EDM;L;41;2;6;8
545;Jesse Winchester;OTT;C;32;2;6;8
546;Brayden McNabb;BUF;D;25;1;7;8
547;Steve Staios;NYI;D;65;0;8;8
548;Nazem Kadri;TOR;C;21;5;2;7
549;Marc-Andre Bourdon;PHI;D;45;4;3;7
550;Chris Porter;STL;L;47;4;3;7
551;Nick Palmieri;NJD, MIN;R;38;4;3;7
552;Kevin Porter;COL;C;35;4;3;7
553;Mark Olver;COL;C;24;4;3;7
554;Kyle Palmieri;ANA;R;18;4;3;7
555;Alexei Emelin;MTL;D;67;3;4;7
556;Trevor Lewis;LAK;C;72;3;4;7
557;Mike Green;WSH;D;32;3;4;7
558;Jonathon Blum;NSH;D;33;3;4;7
559;Mark Flood;WPG;D;33;3;4;7
560;Petteri Nokelainen;PHX, MTL;C;56;3;4;7
561;Andrei Loktionov;LAK;C;39;3;4;7
562;Brandon Yip;COL, NSH;R;35;3;4;7
563;Alexander Radulov;NSH;R;9;3;4;7
564;John Moore;CBJ;D;67;2;5;7
565;Adam Hall;TBL;R;57;2;5;7
566;Cal O'Reilly;NSH, PHX, PIT;C;33;2;5;7
567;Jake Dowell;DAL;C;52;2;5;7
568;Kent Huskins;STL;D;25;2;5;7
569;Trent Hunter;LAK;R;38;2;5;7
570;Casey Wellman;MIN;C;14;2;5;7
571;Nick Schultz;MIN, EDM;D;82;1;6;7
572;Ryan O'Byrne;COL;D;74;1;6;7
573;Cory Sarich;CGY;D;62;1;6;7
574;Marc Methot;CBJ;D;46;1;6;7
575;Keith Ballard;VAN;D;47;1;6;7
576;Tim Jackman;CGY;R;75;1;6;7
577;Matt Taormina;NJD;D;30;1;6;7
578;Dylan Reese;NYI;D;28;1;6;7
579;David Rundblad;OTT, PHX;D;30;1;6;7
580;Brendan Smith;DET;D;14;1;6;7
581;Gustav Nyquist;DET;C;18;1;6;7
582;Sean O'Donnell;CHI;D;51;0;7;7
583;Andrew Ebbett;VAN;C;18;5;1;6
584;Dustin Jeffrey;PIT;L;26;4;2;6
585;Matt Hunwick;COL;D;33;3;3;6
586;Jim O'Brien;OTT;C;28;3;3;6
587;Harry Zolnierczyk;PHI;L;37;3;3;6
588;Jack Hillen;NSH;D;55;2;4;6
589;Anton Lander;EDM;C;56;2;4;6
590;Travis Zajac;NJD;C;15;2;4;6
591;Jeff Schultz;WSH;D;54;1;5;6
592;Jerred Smithson;NSH, FLA;R;69;1;5;6
593;Marty Reasoner;NYI;C;61;1;5;6
594;Mattias Tedenby;NJD;R;43;1;5;6
595;Ian Cole;STL;D;26;1;5;6
596;Steve Bernier;NJD;R;32;1;5;6
597;Jeff Woywitka;NYR;D;27;1;5;6
598;David Van Der Gulik;COL;L;25;1;5;6
599;Ben Maxwell;WPG, ANA, WPG;C;15;1;5;6
600;Henrik Tallinder;NJD;D;39;0;6;6
601;Andreas Lilja;PHI;D;46;0;6;6
602;Jay Beagle;WSH;R;41;4;1;5
603;Mike Rupp;NYR;C;60;4;1;5
604;Marco Sturm;VAN, FLA;L;48;3;2;5
605;Zenon Konopka;OTT;C;55;3;2;5
606;Stephane Da Costa;OTT;C;22;3;2;5
607;Paul Byron;CGY;C;22;3;2;5
608;Marc Staal;NYR;D;46;2;3;5
609;Steve Eminger;NYR;D;42;2;3;5
610;Andrew Gordon;ANA;R;37;2;3;5
611;Blake Geoffrion;NSH, MTL;C;35;2;3;5
612;Krystofer Barch;DAL, FLA;R;51;2;3;5
613;Steven Kampfer;BOS, MIN;D;23;2;3;5
614;Scottie Upshall;FLA;L;26;2;3;5
615;Toby Petersen;DAL;C;39;2;3;5
616;Joakim Lindstrom;COL;C;16;2;3;5
617;Teemu Hartikainen;EDM;L;17;2;3;5
618;Trevor Smith;TBL;C;16;2;3;5
619;Jerome Samson;CAR;R;16;2;3;5
620;Michal Repik;FLA;R;17;2;3;5
621;Robyn Regehr;BUF;D;76;1;4;5
622;Mike Weber;BUF;D;51;1;4;5
623;Clayton Stoner;MIN;D;51;1;4;5
624;Mike Komisarek;TOR;D;45;1;4;5
625;Warren Peters;MIN;C;58;1;4;5
626;Erik Gustafsson;PHI;D;30;1;4;5
627;Ben Lovejoy;PIT;D;34;1;4;5
628;Darryl Boyce;TOR, CBJ;C;37;1;4;5
629;Aaron Palushaj;MTL;R;38;1;4;5
630;Joe Colborne;TOR;C;10;1;4;5
631;Keaton Ellerby;FLA;D;40;0;5;5
632;Dana Tyrell;TBL;C;26;0;5;5
633;Ryan Reaves;STL;R;60;3;1;4
634;Derek Joslin;CAR;D;44;2;2;4
635;Mike Brown;TOR;R;50;2;2;4
636;Mike Blunden;MTL;R;39;2;2;4
637;Patrick O'Sullivan;PHX;C;23;2;2;4
638;Jordan Nolan;LAK;C;26;2;2;4
639;Peter Regin;OTT;C;10;2;2;4
640;Mark Eaton;NYI;D;62;1;3;4
641;Colin White;SJS;D;54;1;3;4
642;Brett Lebda;CBJ;D;30;1;3;4
643;Cody McCormick;BUF;C;50;1;3;4
644;Maxime Macenauer;ANA;C;29;1;3;4
645;Andrew Murray;SJS;C;39;1;3;4
646;Ethan Moreau;LAK;L;28;1;3;4
647;George Parros;ANA;R;46;1;3;4
648;Jim Vandermeer;SJS;D;25;1;3;4
649;Simon Despres;PIT;D;18;1;3;4
650;Evgeny Grachev;STL;C;26;1;3;4
651;Byron Bitz;VAN;R;10;1;3;4
652;Paul Szczechura;BUF;C;9;1;3;4
653;Douglas Murray;SJS;D;60;0;4;4
654;Brandon McMillan;ANA;C;25;0;4;4
655;Alexandre Picard;PIT;D;17;0;4;4
656;Casey Cizikas;NYI;C;15;0;4;4
657;Marc-Antoine Pouliot;PHX;C;13;0;4;4
658;John Madden;FLA;C;31;3;0;3
659;Linus Omark;EDM;L;14;3;0;3
660;Sean Avery;NYR;L;15;3;0;3
661;Sven Baertschi;CGY;L;5;3;0;3
662;Andrew Alberts;VAN;D;44;2;1;3
663;Jared Boll;CBJ;R;54;2;1;3
664;Rod Pelley;NJD, ANA;C;52;2;1;3
665;Eric Fehr;WPG;R;35;2;1;3
666;Ryan Garbutt;DAL;C;20;2;1;3
667;Evgenii Dadonov;FLA;R;15;2;1;3
668;Mats Zuccarello;NYR;L;10;2;1;3
669;Jaden Schwartz;STL;L;7;2;1;3
670;Akim Aliu;CGY;R;2;2;1;3
671;Theo Peckham;EDM;D;54;1;2;3
672;Jay Pandolfo;NYI;L;62;1;2;3
673;Brendan Mikkelson;TBL;D;41;1;2;3
674;Michael Sauer;NYR;D;19;1;2;3
675;Matt Carkner;OTT;D;29;1;2;3
676;B.J. Crombeen;STL;R;40;1;2;3
677;Sami Lepisto;CHI;D;26;1;2;3
678;Lance Bouma;CGY;C;27;1;2;3
679;Colby Armstrong;TOR;R;29;1;2;3
680;Frédéric St-Denis;MTL;D;17;1;2;3
681;Tyson Strachan;FLA;D;15;1;2;3
682;Jan Mursak;DET;L;25;1;2;3
683;Darcy Hordichuk;EDM;L;43;1;2;3
684;Michael Stone;PHX;D;13;1;2;3
685;Zac Dalpe;CAR;C;16;1;2;3
686;Carson McMillan;MIN;R;11;1;2;3
687;Chris Conner;DET;R;8;1;2;3
688;Adam Pardy;DAL;D;36;0;3;3
689;Keith Aulie;TOR, TBL;D;36;0;3;3
690;Ryan White;MTL;C;20;0;3;3
691;Chris Summers;PHX;D;21;0;3;3
692;Andrei Markov;MTL;D;13;0;3;3
693;Matt Calvert;CBJ;L;13;0;3;3
694;Brett Sutter;CAR;L;15;0;3;3
695;Brett Bulmer;MIN;R;9;0;3;3
696;Ryan Russell;CBJ;L;41;2;0;2
697;Cam Barker;EDM;D;25;2;0;2
698;Nate Guenin;ANA;D;15;2;0;2
699;Matt Kassian;MIN;L;24;2;0;2
700;Ben Smith;CHI;R;13;2;0;2
701;Davis Drewiske;LAK;D;9;2;0;2
702;Scott Parse;LAK;R;9;2;0;2
703;Chad Rau;MIN;C;9;2;0;2
704;Randy Jones;WPG;D;39;1;1;2
705;Jed Ortmeyer;MIN;R;35;1;1;2
706;Tim Kennedy;FLA;C;27;1;1;2
707;Kevin Westgarth;LAK;R;25;1;1;2
708;Maksim Mayorov;CBJ;L;10;1;1;2
709;Tomas Kubalik;CBJ;R;8;1;1;2
710;Niclas Bergfors;NSH;R;11;1;1;2
711;Jason Williams;PIT;C;8;1;1;2
712;Josh Green;EDM;C;7;1;1;2
713;David McIntyre;MIN;C;7;1;1;2
714;Mark Fistric;DAL;D;60;0;2;2
715;Mike Mottau;NYI, BOS;D;35;0;2;2
716;Christopher Tanev;VAN;D;25;0;2;2
717;Mike Commodore;DET, TBL;D;30;0;2;2
718;Mike Lundin;MIN;D;17;0;2;2
719;John Erskine;WSH;D;28;0;2;2
720;Tim Erixon;NYR;D;18;0;2;2
721;Stephane Veilleux;NJD, MIN;L;22;0;2;2
722;Eric Tangradi;PIT;L;24;0;2;2
723;Zach Hamill;BOS;C;16;0;2;2
724;Rob Klinkhammer;OTT;C;15;0;2;2
725;Peter Harrold;NJD;D;11;0;2;2
726;Brian McGrattan;NSH;R;30;0;2;2
727;Zach Boychuk;CAR;L;16;0;2;2
728;Brad Malone;COL;C;9;0;2;2
729;Pierre-Cedric Labrie;TBL;L;14;0;2;2
730;Brandon Pirri;CHI;C;5;0;2;2
731;Jason Zucker;MIN;L;6;0;2;2
732;Jeff Taffe;MIN;L;5;0;2;2
733;Mike Duco;VAN;R;6;0;2;2
734;Brett MacLean;WPG;L;5;0;2;2
735;Jordie Benn;DAL;D;3;0;2;2
736;Nino Niederreiter;NYI;R;55;1;0;1
737;Brad Staubitz;MIN, MTL;R;62;1;0;1
738;Aaron Volpatti;VAN;L;23;1;0;1
739;Paul Bissonnette;PHX;L;31;1;0;1
740;TJ Brennan;BUF;D;11;1;0;1
741;Radek Martinek;CBJ;D;7;1;0;1
742;Alexandre Giroux;CBJ;L;9;1;0;1
743;Cody Almond;MIN;C;10;1;0;1
744;Jarod Palmer;MIN;C;6;1;0;1
745;Mark Scheifele;WPG;C;7;1;0;1
746;Alexander Urbom;NJD;D;5;1;0;1
747;Bill Thomas;FLA;R;7;1;0;1
748;Chris VandeVelde;EDM;C;5;1;0;1
749;Mike Angelidis;TBL;L;6;1;0;1
750;Peter Holland;ANA;C;4;1;0;1
751;Colton Orr;TOR;R;5;1;0;1
752;Carter Camper;BOS;C;3;1;0;1
753;Adam Cracknell;STL;R;2;1;0;1
754;Travis Turnbull;BUF;C;3;1;0;1
755;Stephen Gionta;NJD;R;1;1;0;1
756;Dylan Olsen;CHI;D;28;0;1;1
757;Colten Teubert;EDM;D;24;0;1;1
758;John Scott;CHI, NYR;L;35;0;1;1
759;Cam Janssen;NJD;R;48;0;1;1
760;Brad Mills;NJD;C;27;0;1;1
761;Jody Shelley;PHI;L;30;0;1;1
762;Doug Janik;DET;D;9;0;1;1
763;Krys Kolanos;CGY;C;13;0;1;1
764;Cody Bass;CBJ;C;14;0;1;1
765;Mika Zibanejad;OTT;C;9;0;1;1
766;Brian Strait;PIT;D;9;0;1;1
767;Patrick Eaves;DET;R;10;0;1;1
768;Tom Sestito;PHI;L;14;0;1;1
769;Nikita Filatov;OTT;L;9;0;1;1
770;Jason Jaffray;WPG;C;13;0;1;1
771;Ryan O'Marra;EDM, ANA;C;9;0;1;1
772;J.T. Brown;TBL;R;5;0;1;1
773;Riley Nash;CAR;C;5;0;1;1
774;Andre Deveaux;NYR;C;9;0;1;1
775;Cade Fairchild;STL;D;5;0;1;1
776;Mark Cullen;FLA;C;6;0;1;1
777;Fabian Brunnstrom;DET;L;5;0;1;1
778;Torey Krug;BOS;D;2;0;1;1
779;Alex Plante;EDM;D;3;0;1;1
780;Ryan Hamilton;TOR;L;2;0;1;1
781;Philippe Cornet;EDM;L;2;0;1;1
782;Chay Genoway;MIN;D;1;0;1;1
783;Carl Sneep;PIT;D;1;0;1;1
784;Eric Boulton;NJD;L;51;0;0;0
785;Philippe Dupuis;TOR;C;30;0;0;0
786;Jay Rosehill;TOR;L;31;0;0;0
787;Tyson Barrie;COL;D;10;0;0;0
788;Carter Ashton;TOR;R;15;0;0;0
789;Aaron Ness;NYI;D;9;0;0;0
790;Tim Sestito;NJD;C;18;0;0;0
791;Micheal Haley;NYI;C;14;0;0;0
792;Brandon Bollig;CHI;L;18;0;0;0
793;Teemu Laakso;NSH;D;9;0;0;0
794;Arturs Kulda;WPG;D;9;0;0;0
795;John McCarthy;SJS;C;10;0;0;0
796;Kevin Marshall;PHI, WSH;D;10;0;0;0
797;Andreas Engqvist;MTL;C;12;0;0;0
798;Steven Zalewski;NJD;C;7;0;0;0
799;Guillaume Desbiens;CGY;R;10;0;0;0
800;Taylor Chorney;STL, EDM;D;5;0;0;0
801;Greg Nemisz;CGY;C;9;0;0;0
802;Clay Wilson;CGY;D;5;0;0;0
803;Aaron Gagnon;WPG;C;7;0;0;0
804;Brandon Segal;TBL;R;10;0;0;0
805;Brett Festerling;WPG;D;5;0;0;0
806;Robert Bortuzzo;PIT;D;6;0;0;0
807;Dane Byers;CBJ;L;8;0;0;0
808;Andy Miele;PHX;C;7;0;0;0
809;Rhett Rakhshani;NYI;R;5;0;0;0
810;Dalton Prout;CBJ;D;5;0;0;0
811;Mark Fraser;NJD;D;4;0;0;0
812;Patrice Cormier;WPG;C;9;0;0;0
813;Matt Donovan;NYI;D;3;0;0;0
814;Kenndal McArdle;WPG;L;9;0;0;0
815;Brandon Manning;PHI;D;4;0;0;0
816;Rostislav Olesz;CHI;L;6;0;0;0
817;Joe Piskula;CGY;D;5;0;0;0
818;Mattias Ritola;TBL;C;5;0;0;0
819;Mark Mancari;VAN;R;6;0;0;0
820;Tomas Kundratek;WSH;D;5;0;0;0
821;Lane MacDermid;BOS;L;5;0;0;0
822;Matt Walker;PHI;D;4;0;0;0
823;Colin McDonald;PIT;R;5;0;0;0
824;Kris Newbury;NYR;C;7;0;0;0
825;Kyle Wilson;NSH;C;5;0;0;0
826;Jean-Francois Jacques;ANA;L;6;0;0;0
827;Joe Finley;BUF;D;5;0;0;0
828;Steve MacIntyre;PIT;L;12;0;0;0
829;Colby Robak;FLA;D;3;0;0;0
830;Chris Mueller;NSH;C;4;0;0;0
831;Bracken Kearns;FLA;C;5;0;0;0
832;Kris Fredheim;MIN;D;3;0;0;0
833;Bobby Sanguinetti;CAR;D;3;0;0;0
834;Frazer McLaren;SJS;L;7;0;0;0
835;Ben Holmstrom;PHI;C;5;0;0;0
836;Joakim Andersson;DET;C;5;0;0;0
837;Carl Klingberg;WPG;L;6;0;0;0
838;Kristian Huselius;CBJ;L;2;0;0;0
839;Mark Bell;ANA;L;5;0;0;0
840;Brett Sterling;STL;L;4;0;0;0
841;Evan Oberg;TBL;D;3;0;0;0
842;Brandon Saad;CHI;L;2;0;0;0
843;Jeremy Morin;CHI;L;3;0;0;0
844;Gabriel Dumont;MTL;C;3;0;0;0
845;Paul Postma;WPG;D;3;0;0;0
846;Reilly Smith;DAL;R;3;0;0;0
847;Patrick Maroon;ANA;L;2;0;0;0
848;Derek Whitmore;BUF;L;2;0;0;0
849;Mark Borowiecki;OTT;D;2;0;0;0
850;Mattias Ekholm;NSH;D;2;0;0;0
851;Mike Connolly;COL;L;2;0;0;0
852;Derek Meech;WPG;D;2;0;0;0
853;Brett Carson;CGY;D;2;0;0;0
854;Mat Clark;ANA;D;2;0;0;0
855;Sean Collins;WSH;D;2;0;0;0
856;Josh Hennessy;BOS;C;3;0;0;0
857;Brenden Dillon;DAL;D;1;0;0;0
858;Vladimir Zharkov;NJD;R;4;0;0;0
859;Matt Bartkowski;BOS;D;3;0;0;0
860;Ty Wishart;NYI;D;1;0;0;0
861;Jeremy Welsh;CAR;C;1;0;0;0
862;Pierre-Luc Letourneau-Leblond;CGY;R;3;0;0;0
863;Jon Disalvatore;MIN;R;1;0;0;0
864;Alexandre Bolduc;PHX;C;2;0;0;0
865;Trent Whitfield;BOS;C;1;0;0;0
866;Bryan Rodney;EDM;D;1;0;0;0
867;Calvin de Haan;NYI;D;1;0;0;0
868;Evan Brophey;COL;C;3;0;0;0
869;Colin Stuart;BUF;L;2;0;0;0
870;Brendan Bell;NYR;D;1;0;0;0
871;Tyler Cuma;MIN;D;1;0;0;0
872;Raitis Ivanans;CGY;L;1;0;0;0
873;Bill Sweatt;VAN;L;2;0;0;0
874;Scott Glennie;DAL;R;1;0;0;0
875;Andrew Joudrey;CBJ;C;1;0;0;0
876;Mike Hoffman;OTT;C;1;0;0;0
877;Kristopher Foucault;MIN;L;1;0;0;0
878;Trevor Gillies;NYI;L;3;0;0;0
879;Ryan Thang;NSH;L;1;0;0;0
880;DJ King;WSH;L;1;0;0;0
881;Matt Watkins;PHX;R;1;0;0;0
882;Nolan Yonkman;FLA;D;1;0;0;0
883;Victor Oreskovich;VAN;R;1;0;0;0
884;Riley Sheahan;DET;C;1;0;0;0
885;Cody Goloubef;CBJ;D;1;0;0;0
886;Joel Rechlicz;WSH;R;3;0;0;0
887;Milan Kytnar;EDM;C;1;0;0;0
888;Francis Wathier;DAL;L;1;0;0;0
889;Jon Matsumoto;FLA;C;1;0;0;0
890;Andre Petersson;OTT;R;1;0;0;0
891;Zack Stortini;NSH;R;1;0;0;0
892;Matt Fraser;DAL;R;1;0;0;0
893;Max Sauve;BOS;C;1;0;0;0
894;Greg Rallo;FLA;C;1;0;0;0
