rank;name;old_team;pos;gp;goals;assists;points;f_goals;f_assists;f_points
1;Sidney Crosby;PIT;C;80;36;68;104;72;68;140
2;Ryan Getzlaf;ANA;C;77;31;56;87;62;56;118
3;Claude Giroux;PHI;C;82;28;58;86;56;58;114
4;Tyler Seguin;DAL;C;80;37;47;84;74;47;121
5;Corey Perry;ANA;R;81;43;39;82;86;39;125
6;Phil Kessel;TOR;R;82;37;43;80;74;43;117
7;Taylor Hall;EDM;L;75;27;53;80;54;53;107
8;Alex Ovechkin;WSH;R;78;51;28;79;102;28;130
9;Joe Pavelski;SJS;C;82;41;38;79;82;38;120
10;Jamie Benn;DAL;L;81;34;45;79;68;45;113
11;Nicklas Backstrom;WSH;C;82;18;61;79;36;61;97
12;Patrick Sharp;CHI;L;82;34;44;78;68;44;112
13;Joe Thornton;SJS;C;82;11;65;76;22;65;87
14;Erik Karlsson;OTT;D;82;20;54;74;60;108;168
15;Evgeni Malkin;PIT;C;60;23;49;72;46;49;95
16;Patrick Marleau;SJS;L;82;33;37;70;66;37;103
17;Anze Kopitar;LAK;C;82;29;41;70;58;41;99
18;Matt Duchene;COL;C;71;23;47;70;46;47;93
19;Martin St. Louis;TBL, NYR;R;81;30;39;69;60;39;99
20;Patrick Kane;CHI;R;69;29;40;69;58;40;98
21;Blake Wheeler;WPG;R;82;28;41;69;56;41;97
22;Kyle Okposo;NYI;R;71;27;42;69;54;42;96
23;David Krejci;BOS;C;80;19;50;69;38;50;88
24;Chris Kunitz;PIT;L;78;35;33;68;70;33;103
25;Jonathan Toews;CHI;C;76;28;40;68;56;40;96
26;Thomas Vanek;BUF, NYI, MTL;L;78;27;41;68;54;41;95
27;Jaromir Jagr;NJD;R;82;24;43;67;48;43;91
28;John Tavares;NYI;C;59;24;42;66;48;42;90
29;Jason Spezza;OTT;C;75;23;43;66;46;43;89
30;Jordan Eberle;EDM;R;80;28;37;65;56;37;93
31;Gabriel Landeskog;COL;L;81;26;39;65;52;39;91
32;Ryan O'Reilly;COL;C;80;28;36;64;56;36;92
33;Bryan Little;WPG;C;82;23;41;64;46;41;87
34;Ryan Johansen;CBJ;C;82;33;30;63;66;30;96
35;Nathan MacKinnon;COL;C;82;24;39;63;48;39;87
36;Alexander Steen;STL;L;68;33;29;62;66;29;95
37;Patrice Bergeron;BOS;C;80;30;32;62;60;32;92
38;Jakub Voracek;PHI;R;82;23;39;62;46;39;85
39;James van Riemsdyk;TOR;L;80;30;31;61;60;31;91
40;Jarome Iginla;BOS;R;78;30;31;61;60;31;91
41;James Neal;PIT;L;59;27;34;61;54;34;88
42;Eric Staal;CAR;C;79;21;40;61;42;40;82
43;Duncan Keith;CHI;D;79;6;55;61;18;110;128
44;Max Pacioretty;MTL;L;73;39;21;60;78;21;99
45;Jason Pominville;MIN;R;82;30;30;60;60;30;90
46;Marian Hossa;CHI;R;72;30;30;60;60;30;90
47;Wayne Simmonds;PHI;R;82;29;31;60;58;31;89
48;Paul Stastny;COL;C;71;25;35;60;50;35;85
49;T.J. Oshie;STL;R;79;21;39;60;42;39;81
50;Milan Lucic;BOS;L;80;24;35;59;48;35;83
51;Ondrej Palat;TBL;L;81;23;36;59;46;36;82
52;Mats Zuccarello;NYR;L;77;19;40;59;38;40;78
53;Kyle Turris;OTT;C;82;26;32;58;52;32;84
54;Valtteri Filppula;TBL;C;75;25;33;58;50;33;83
55;Frans Nielsen;NYI;C;80;25;33;58;50;33;83
56;David Perron;EDM;L;78;28;29;57;56;29;85
57;David Backes;STL;C;74;27;30;57;54;30;84
58;Jussi Jokinen;PIT;L;81;21;36;57;42;36;78
59;Derek Stepan;NYR;C;82;17;40;57;34;40;74
60;Zach Parise;MIN;L;67;29;27;56;58;27;85
61;Jaden Schwartz;STL;L;80;25;31;56;50;31;81
62;Shea Weber;NSH;D;79;23;33;56;69;66;135
63;Dustin Byfuglien;WPG;R;78;20;36;56;40;36;76
64;Ryan Nugent-Hopkins;EDM;C;80;19;37;56;38;37;75
65;Clarke MacArthur;OTT;L;79;24;31;55;48;31;79
66;Victor Hedman;TBL;D;75;13;42;55;39;84;123
67;Jeff Skinner;CAR;L;71;33;21;54;66;21;87
68;Andrew Ladd;WPG;L;78;23;31;54;46;31;77
69;Logan Couture;SJS;C;65;23;31;54;46;31;77
70;Jiri Hudler;CGY;C;75;17;37;54;34;37;71
71;Mikko Koivu;MIN;C;65;11;43;54;22;43;65
72;Brad Marchand;BOS;L;82;25;28;53;50;28;78
73;Patric Hornqvist;NSH;R;76;22;31;53;44;31;75
74;Patrik Elias;NJD;L;65;18;35;53;36;35;71
75;P.K. Subban;MTL;D;82;10;43;53;30;86;116
76;Keith Yandle;PHX;D;82;8;45;53;24;90;114
77;Craig Smith;NSH;C;79;24;28;52;48;28;76
78;Scott Hartnell;PHI;L;78;20;32;52;40;32;72
79;David Desharnais;MTL;C;79;16;36;52;32;36;68
80;Matt Moulson;NYI, BUF, MIN;L;75;23;28;51;46;28;74
81;Brad Richards;NYR;C;82;20;31;51;40;31;71
82;Radim Vrbata;PHX;R;80;20;31;51;40;31;71
83;Reilly Smith;BOS;R;82;20;31;51;40;31;71
84;Mikkel Boedker;PHX;L;82;19;32;51;38;32;70
85;David Legwand;NSH, DET;C;83;14;37;51;28;37;65
86;Alex Pietrangelo;STL;D;81;8;43;51;24;86;110
87;James Wisniewski;CBJ;D;75;7;44;51;21;88;109
88;Jeff Carter;LAK;C;72;27;23;50;54;23;77
89;Tyler Johnson;TBL;C;82;24;26;50;48;26;74
90;Nazem Kadri;TOR;C;78;20;30;50;40;30;70
91;Brandon Dubinsky;CBJ;C;76;16;34;50;32;34;66
92;Henrik Sedin;VAN;C;70;11;39;50;22;39;61
93;Joel Ward;WSH;R;82;24;25;49;48;25;73
94;Nick Bonino;ANA;C;77;22;27;49;44;27;71
95;Mike Fisher;NSH;C;75;20;29;49;40;29;69
96;Tyler Bozak;TOR;C;58;19;30;49;38;30;68
97;Daniel Alfredsson;DET;R;68;18;31;49;36;31;67
98;Niklas Kronwall;DET;D;79;8;41;49;24;82;106
99;Gustav Nyquist;DET;R;57;28;20;48;56;20;76
100;Bobby Ryan;OTT;R;70;23;25;48;46;25;71
101;Brent Burns;SJS;D;69;22;26;48;66;52;118
102;Travis Zajac;NJD;C;80;18;30;48;36;30;66
103;Carl Soderberg;BOS;C;73;16;32;48;32;32;64
104;Henrik Zetterberg;DET;L;45;16;32;48;32;32;64
105;Shane Doan;PHX;R;69;23;24;47;46;24;70
106;Brandon Saad;CHI;L;78;19;28;47;38;28;66
107;Daniel Sedin;VAN;L;73;16;31;47;32;31;63
108;Mike Ribeiro;PHX;C;80;16;31;47;32;31;63
109;Mark Giordano;CGY;D;64;14;33;47;42;66;108
110;Matt Niskanen;PIT;D;81;10;36;46;30;72;102
111;Mike Cammalleri;CGY;C;63;26;19;45;52;19;71
112;Antoine Vermette;PHX;C;82;24;21;45;48;21;69
113;Mason Raymond;TOR;L;82;19;26;45;38;26;64
114;Derick Brassard;NYR;C;81;18;27;45;36;27;63
115;Kevin Shattenkirk;STL;D;81;10;35;45;30;70;100
116;Joffrey Lupul;TOR;L;69;22;22;44;44;22;66
117;Cody Hodgson;BUF;C;72;20;24;44;40;24;64
118;Oliver Ekman-Larsson;PHX;D;80;15;29;44;45;58;103
119;Andrej Sekera;CAR;D;74;11;33;44;33;66;99
120;Mark Streit;PHI;D;82;10;34;44;30;68;98
121;Marcus Johansson;WSH;C;80;8;36;44;16;36;52
122;Ryan Kesler;VAN;C;77;25;18;43;50;18;68
123;Troy Brouwer;WSH;R;82;25;18;43;50;18;68
124;Adam Henrique;NJD;C;77;25;18;43;50;18;68
125;Tyler Ennis;BUF;C;80;21;22;43;42;22;64
126;Vladimir Tarasenko;STL;R;64;21;22;43;42;22;64
127;Tomas Plekanec;MTL;C;81;20;23;43;40;23;63
128;Justin Williams;LAK;R;82;19;24;43;38;24;62
129;Olli Jokinen;WPG;C;82;18;25;43;36;25;61
130;Mathieu Perreault;ANA;C;69;18;25;43;36;25;61
131;Ryan McDonagh;NYR;D;77;14;29;43;42;58;100
132;Ales Hemsky;EDM, OTT;R;75;13;30;43;26;30;56
133;Ryan Suter;MIN;D;82;8;35;43;24;70;94
134;Andrei Markov;MTL;D;81;7;36;43;21;72;93
135;Alexander Semin;CAR;R;65;22;20;42;44;20;64
136;Andrew Cogliano;ANA;C;82;21;21;42;42;21;63
137;Michael Frolik;WPG;R;81;15;27;42;30;27;57
138;Jason Chimera;WSH;L;82;15;27;42;30;27;57
139;Marek Zidlicky;NJD;D;81;12;30;42;36;60;96
140;Teddy Purcell;TBL;R;81;12;30;42;24;30;54
141;Alex Goligoski;DAL;D;81;6;36;42;18;72;90
142;Brayden Schenn;PHI;C;82;20;21;41;40;21;61
143;Brendan Gallagher;MTL;R;81;19;22;41;38;22;60
144;Evander Kane;WPG;L;63;19;22;41;38;22;60
145;Alex Killorn;TBL;C;82;17;24;41;34;24;58
146;Johan Franzen;DET;R;54;16;25;41;32;25;57
147;Mike Richards;LAK;C;82;11;30;41;22;30;52
148;Mikael Granlund;MIN;C;63;8;33;41;16;33;49
149;Brent Seabrook;CHI;D;82;7;34;41;21;68;89
150;Steven Stamkos;TBL;C;37;25;15;40;50;15;65
151;Matt Read;PHI;R;75;22;18;40;44;18;62
152;Cam Atkinson;CBJ;R;79;21;19;40;42;19;61
153;Brian Gionta;MTL;R;81;18;22;40;36;22;58
154;Zdeno Chara;BOS;D;77;17;23;40;51;46;97
155;Jordan Staal;CAR;C;82;15;25;40;30;25;55
156;Martin Hanzal;PHX;C;65;15;25;40;30;25;55
157;Torey Krug;BOS;D;79;14;26;40;42;52;94
158;Roman Josi;NSH;D;72;13;27;40;39;54;93
159;Rick Nash;NYR;L;65;26;13;39;52;13;65
160;Artem Anisimov;CBJ;C;81;22;17;39;44;17;61
161;Andrew Shaw;CHI;C;80;20;19;39;40;19;59
162;Tomas Tatar;DET;L;73;19;20;39;38;20;58
163;Mikael Backlund;CGY;C;76;18;21;39;36;21;57
164;Nick Foligno;CBJ;L;70;18;21;39;36;21;57
165;Chris Higgins;VAN;L;78;17;22;39;34;22;56
166;Milan Michalek;OTT;L;82;17;22;39;34;22;56
167;Sean Couturier;PHI;C;82;13;26;39;26;26;52
168;Matt Cullen;NSH;C;77;10;29;39;20;29;49
169;Erik Johnson;COL;D;80;9;30;39;27;60;87
170;Jamie McGinn;COL;L;79;19;19;38;38;19;57
171;Tommy Wingels;SJS;C;77;16;22;38;32;22;54
172;Nick Bjugstad;FLA;C;76;16;22;38;32;22;54
173;Tyson Barrie;COL;D;64;13;25;38;39;50;89
174;Mike Green;WSH;D;70;9;29;38;27;58;85
175;Josh Bailey;NYI;L;77;8;30;38;16;30;46
176;Vincent Lecavalier;PHI;C;69;20;17;37;40;17;57
177;Chris Kreider;NYR;L;66;17;20;37;34;20;54
178;Pavel Datsyuk;DET;C;45;17;20;37;34;20;54
179;Scottie Upshall;FLA;L;76;15;22;37;30;22;52
180;John Carlson;WSH;D;82;10;27;37;30;54;84
181;Drew Doughty;LAK;D;78;10;27;37;30;54;84
182;Sam Gagner;EDM;C;67;10;27;37;20;27;47
183;Loui Eriksson;BOS;R;61;10;27;37;20;27;47
184;Derek Roy;STL;C;75;9;28;37;18;28;46
185;Brian Campbell;FLA;D;82;7;30;37;21;60;81
186;Jay Bouwmeester;STL;D;82;4;33;37;12;66;78
187;Brad Boyes;FLA;R;78;21;15;36;42;15;57
188;Ryan Callahan;NYR, TBL;R;65;17;19;36;34;19;53
189;Benoit Pouliot;NYR;L;80;15;21;36;30;21;51
190;Nino Niederreiter;MIN;R;81;14;22;36;28;22;50
191;Dan Boyle;SJS;D;75;12;24;36;36;48;84
192;Kris Versteeg;FLA, CHI;L;81;12;24;36;24;24;48
193;Cam Fowler;ANA;D;70;6;30;36;18;60;78
194;Cody Eakin;DAL;C;81;16;19;35;32;19;51
195;Dustin Penner;ANA, WSH;R;67;14;21;35;28;21;49
196;Alex Chiasson;DAL;R;79;13;22;35;26;22;48
197;Mikhail Grabovski;WSH;C;58;13;22;35;26;22;48
198;Kimmo Timonen;PHI;D;77;6;29;35;18;58;76
199;Sean Monahan;CGY;C;75;22;12;34;44;12;56
200;Michael Ryder;NJD;R;82;18;16;34;36;16;52
201;R.J. Umberger;CBJ;C;74;18;16;34;36;16;52
202;Drew Stafford;BUF;R;70;16;18;34;32;18;50
203;Valeri Nichushkin;DAL;R;79;14;20;34;28;20;48
204;Mark Scheifele;WPG;C;63;13;21;34;26;21;47
205;Lee Stempniak;CGY, PIT;R;73;12;22;34;24;22;46
206;Mark Letestu;CBJ;C;82;12;22;34;24;22;46
207;Jason Demers;SJS;D;75;5;29;34;15;58;73
208;Slava Voynov;LAK;D;82;4;30;34;12;60;72
209;Carl Hagelin;NYR;L;72;17;16;33;34;16;50
210;Mika Zibanejad;OTT;C;69;16;17;33;32;17;49
211;Matt Stajan;CGY;C;63;14;19;33;28;19;47
212;Pierre-Alexandre Parenteau;COL;R;55;14;19;33;28;19;47
213;Justin Schultz;EDM;D;74;11;22;33;33;44;77
214;Colin Wilson;NSH;C;81;11;22;33;22;22;44
215;Vladimir Sobotka;STL;L;61;9;24;33;18;24;42
216;Jason Garrison;VAN;D;81;7;26;33;21;52;73
217;Christian Ehrhoff;BUF;D;79;6;27;33;18;54;72
218;Jack Johnson;CBJ;D;82;5;28;33;15;56;71
219;Cody Franson;TOR;D;79;5;28;33;15;56;71
220;Ryan Garbutt;DAL;L;75;17;15;32;34;15;49
221;Patrik Berglund;STL;C;78;14;18;32;28;18;46
222;Nick Spaling;NSH;C;71;13;19;32;26;19;45
223;John Mitchell;COL;C;75;11;21;32;22;21;43
224;Ray Whitney;DAL;L;69;9;23;32;18;23;41
225;Andy Greene;NJD;D;82;8;24;32;24;48;72
226;Justin Faulk;CAR;D;76;5;27;32;15;54;69
227;Nathan Gerbe;CAR;L;81;16;15;31;32;15;47
228;Kyle Palmieri;ANA;R;71;14;17;31;28;17;45
229;Eric Fehr;WSH;R;73;13;18;31;26;18;44
230;Alex Galchenyuk;MTL;C;65;13;18;31;26;18;44
231;Jake Gardiner;TOR;D;80;10;21;31;30;42;72
232;Dion Phaneuf;TOR;D;80;8;23;31;24;46;70
233;Nick Leddy;CHI;D;82;7;24;31;21;48;69
234;TJ Brodie;CGY;D;81;4;27;31;12;54;66
235;Matthew Carle;TBL;D;82;2;29;31;6;58;64
236;Jiri Tlusty;CAR;L;68;16;14;30;32;14;46
237;Dwight King;LAK;L;77;15;15;30;30;15;45
238;Charlie Coyle;MIN;C;70;12;18;30;24;18;42
239;Marian Gaborik;CBJ, LAK;R;41;11;19;30;22;19;41
240;Tobias Enstrom;WPG;D;82;10;20;30;30;40;70
241;Rich Peverley;DAL;C;62;7;23;30;14;23;37
242;Hampus Lindholm;ANA;D;78;6;24;30;18;48;66
243;Daniel Winnik;ANA;C;76;6;24;30;12;24;36
244;Erik Cole;DAL;L;75;16;13;29;32;13;45
245;Sean Bergenheim;FLA;L;62;16;13;29;32;13;45
246;Boone Jenner;CBJ;C;72;16;13;29;32;13;45
247;Antoine Roussel;DAL;L;81;14;15;29;28;15;43
248;Zack Kassian;VAN;R;73;14;15;29;28;15;43
249;Tyler Toffoli;LAK;C;62;12;17;29;24;17;41
250;Saku Koivu;ANA;C;65;11;18;29;22;18;40
251;Patrick Maroon;ANA;L;62;11;18;29;22;18;40
252;Jacob Trouba;WPG;D;65;10;19;29;30;38;68
253;Olli Maatta;PIT;D;78;9;20;29;27;40;67
254;Kris Russell;CGY;D;68;7;22;29;21;44;65
255;Eric Gelinas;NJD;D;60;7;22;29;21;44;65
256;Martin Erat;WSH, PHX;R;70;3;26;29;6;26;32
257;Dany Heatley;MIN;L;76;12;16;28;24;16;40
258;Matt Cooke;MIN;L;82;10;18;28;20;18;38
259;Joe Colborne;CGY;C;80;10;18;28;20;18;38
260;Justin Abdelkader;DET;L;70;10;18;28;20;18;38
261;Mike Santorelli;VAN;C;49;10;18;28;20;18;38
262;Jonathan Huberdeau;FLA;L;69;9;19;28;18;19;37
263;Tomas Fleischmann;FLA;L;80;8;20;28;16;20;36
264;Marcus Kruger;CHI;C;81;8;20;28;16;20;36
265;Andre Benoit;COL;D;79;7;21;28;21;42;63
266;Andrew MacDonald;NYI, PHI;D;82;4;24;28;12;48;60
267;Tom Gilbert;FLA;D;73;3;25;28;9;50;59
268;Dustin Brown;LAK;R;79;15;12;27;30;12;42
269;Devin Setoguchi;WPG;R;75;11;16;27;22;16;38
270;Teemu Selanne;ANA;R;64;9;18;27;18;18;36
271;Maxime Talbot;PHI, COL;C;81;8;19;27;16;19;35
272;Jarret Stoll;LAK;C;78;8;19;27;16;19;35
273;Ryan Ellis;NSH;D;80;6;21;27;18;42;60
274;Morgan Rielly;TOR;D;73;2;25;27;6;50;56
275;Chris Stewart;STL, BUF;R;63;15;11;26;30;11;41
276;Brock Nelson;NYI;C;72;14;12;26;28;12;40
277;Ben Smith;CHI;R;75;14;12;26;28;12;40
278;Dainius Zubrus;NJD;R;82;13;13;26;26;13;39
279;Brandon Sutter;PIT;C;81;13;13;26;26;13;39
280;Lars Eller;MTL;C;77;12;14;26;24;14;38
281;Michael Grabner;NYI;R;64;12;14;26;24;14;38
282;Gabriel Bourque;NSH;L;74;9;17;26;18;17;35
283;Cory Conacher;OTT, BUF;C;79;7;19;26;14;19;33
284;Ryane Clowe;NJD;L;43;7;19;26;14;19;33
285;Jared Spurgeon;MIN;D;67;5;21;26;15;42;57
286;Niklas Hjalmarsson;CHI;D;81;4;22;26;12;44;56
287;Fedor Tyutin;CBJ;D;69;4;22;26;12;44;56
288;Tomas Hertl;SJS;C;37;15;10;25;30;10;40
289;Daniel Briere;MTL;C;69;13;12;25;26;12;38
290;Brenden Morrow;STL;L;71;13;12;25;26;12;38
291;Brandon Pirri;CHI, FLA;C;49;13;12;25;26;12;38
292;Marcel Goc;FLA, PIT;C;74;11;14;25;22;14;36
293;Damien Brunner;NJD;R;60;11;14;25;22;14;36
294;Nick Holden;COL;D;54;10;15;25;30;30;60
295;Trevor Daley;DAL;D;67;9;16;25;27;32;59
296;Lauri Korpikoski;PHX;L;64;9;16;25;18;16;34
297;Dougie Hamilton;BOS;D;64;7;18;25;21;36;57
298;Seth Jones;NSH;D;77;6;19;25;18;38;56
299;Curtis Glencross;CGY;L;38;12;12;24;24;12;36
300;Nail Yakupov;EDM;R;63;11;13;24;22;13;35
301;Matt Nieto;SJS;L;66;10;14;24;20;14;34
302;Riley Nash;CAR;C;73;10;14;24;20;14;34
303;Matt Calvert;CBJ;L;56;9;15;24;18;15;33
304;Matt Beleskey;ANA;L;55;9;15;24;18;15;33
305;Riley Sheahan;DET;C;42;9;15;24;18;15;33
306;Kyle Brodziak;MIN;C;81;8;16;24;16;16;32
307;Tuomo Ruutu;CAR, NJD;R;76;8;16;24;16;16;32
308;Aleksander Barkov;FLA;C;54;8;16;24;16;16;32
309;Dan Girardi;NYR;D;81;5;19;24;15;38;53
310;Marc-Edouard Vlasic;SJS;D;81;5;19;24;15;38;53
311;Jake Muzzin;LAK;D;76;5;19;24;15;38;53
312;Kevin Bieksa;VAN;D;76;4;20;24;12;40;52
313;Steve Downie;COL, PHI;R;62;4;20;24;8;20;28
314;Shawn Matthias;FLA, VAN;C;77;12;11;23;24;11;35
315;Brad Richardson;VAN;R;73;11;12;23;22;12;34
316;Ryan Smyth;EDM;L;72;10;13;23;20;13;33
317;Jakob Silfverberg;ANA;R;52;10;13;23;20;13;33
318;Steve Ott;BUF, STL;C;82;9;14;23;18;14;32
319;Marc Methot;OTT;D;75;6;17;23;18;34;52
320;Vernon Fiddler;DAL;C;76;6;17;23;12;17;29
321;Johnny Boychuk;BOS;D;75;5;18;23;15;36;51
322;Danny DeKeyser;DET;D;65;4;19;23;12;38;50
323;Patrick Wiercioch;OTT;D;53;4;19;23;12;38;50
324;Zack Smith;OTT;C;82;13;9;22;26;9;35
325;Marty Havlat;SJS;R;48;12;10;22;24;10;34
326;Alec Martinez;LAK;D;61;11;11;22;33;22;55
327;Kris Letang;PIT;D;37;11;11;22;33;22;55
328;Tyler Myers;BUF;D;62;9;13;22;27;26;53
329;Michael Raffl;PHI;L;68;9;13;22;18;13;31
330;David Moss;PHX;R;79;8;14;22;16;14;30
331;Patrick Dwyer;CAR;R;75;8;14;22;16;14;30
332;Zemgus Girgensons;BUF;C;70;8;14;22;16;14;30
333;Alexander Edler;VAN;D;63;7;15;22;21;30;51
334;Andrej Meszaros;PHI, BOS;D;52;7;15;22;21;30;51
335;Andrei Loktionov;NJD, CAR;C;68;7;15;22;14;15;29
336;Dan Hamhuis;VAN;D;79;5;17;22;15;34;49
337;Thomas Hickey;NYI;D;82;4;18;22;12;36;48
338;Radko Gudas;TBL;D;73;3;19;22;9;38;47
339;Sergei Gonchar;DAL;D;76;2;20;22;6;40;46
340;Eric Nystrom;NSH;L;79;15;6;21;30;6;36
341;Justin Fontaine;MIN;R;66;13;8;21;26;8;34
342;Paul Gaustad;NSH;C;75;10;11;21;20;11;31
343;Elias Lindholm;CAR;C;58;9;12;21;18;12;30
344;Michael Stone;PHX;D;70;8;13;21;24;26;50
345;Boyd Gordon;EDM;C;74;8;13;21;16;13;29
346;Gregory Campbell;BOS;C;82;8;13;21;16;13;29
347;Paul Byron;CGY;C;47;7;14;21;14;14;28
348;Sami Vatanen;ANA;D;48;6;15;21;18;30;48
349;Ryan Murray;CBJ;D;66;4;17;21;12;34;46
350;Dennis Wideman;CGY;D;46;4;17;21;12;34;46
351;Darren Helm;DET;C;42;12;8;20;24;8;32
352;Jannik Hansen;VAN;R;71;11;9;20;22;9;31
353;Rob Klinkhammer;PHX;C;72;11;9;20;22;9;31
354;Nikolai Kulemin;TOR;L;70;9;11;20;18;11;29
355;Shawn Horcoff;DAL;C;77;7;13;20;14;13;27
356;Pascal Dupuis;PIT;R;39;7;13;20;14;13;27
357;Kyle Chipchura;PHX;C;80;5;15;20;10;15;25
358;James Sheppard;SJS;L;67;4;16;20;8;16;24
359;Jordie Benn;DAL;D;78;3;17;20;9;34;43
360;Cal Clutterbuck;NYI;R;73;12;7;19;24;7;31
361;David Booth;VAN;L;66;9;10;19;18;10;28
362;Jonas Brodin;MIN;D;79;8;11;19;24;22;46
363;Dmitry Kulikov;FLA;D;81;8;11;19;24;22;46
364;Marcus Foligno;BUF;L;74;7;12;19;14;12;26
365;Brendan Smith;DET;D;71;5;14;19;15;28;43
366;Nathan Horton;CBJ;R;36;5;14;19;10;14;24
367;J.T. Brown;TBL;R;63;4;15;19;8;15;23
368;Matt Irwin;SJS;D;62;2;17;19;6;34;40
369;Jakub Kindl;DET;D;66;2;17;19;6;34;40
370;Jimmy Hayes;CHI, FLA;R;55;11;7;18;22;7;29
371;Chris Kelly;BOS;C;57;9;9;18;18;9;27
372;Derek MacKenzie;CBJ;C;71;9;9;18;18;9;27
373;Daniel Paille;BOS;L;72;9;9;18;18;9;27
374;Nikita Kucherov;TBL;R;52;9;9;18;18;9;27
375;Jesse Winchester;FLA;C;52;9;9;18;18;9;27
376;Viktor Stalberg;NSH;L;70;8;10;18;16;10;26
377;Colin McDonald;NYI;R;70;8;10;18;16;10;26
378;Ryan Strome;NYI;C;37;7;11;18;14;11;25
379;Brian Boyle;NYR;C;82;6;12;18;12;12;24
380;Dominic Moore;NYR;C;73;6;12;18;12;12;24
381;Ben Lovejoy;ANA;D;78;5;13;18;15;26;41
382;Mark Arcobello;EDM;C;41;4;14;18;8;14;22
383;Travis Hamonic;NYI;D;69;3;15;18;9;30;39
384;Andrew Ference;EDM;D;71;3;15;18;9;30;39
385;Karl Alzner;WSH;D;82;2;16;18;6;32;38
386;Matt Bartkowski;BOS;D;64;0;18;18;0;36;36
387;David Jones;CGY;R;48;9;8;17;18;8;26
388;Joakim Andersson;DET;C;65;8;9;17;16;9;25
389;Jeff Petry;EDM;D;80;7;10;17;21;20;41
390;Jan Hejda;COL;D;78;6;11;17;18;22;40
391;Brenden Dillon;DAL;D;80;6;11;17;18;22;40
392;Jamie McBain;BUF;D;69;6;11;17;18;22;40
393;Christopher Tanev;VAN;D;64;6;11;17;18;22;40
394;Colin Greening;OTT;L;76;6;11;17;12;11;23
395;Braydon Coburn;PHI;D;82;5;12;17;15;24;39
396;Derek Morris;PHX;D;63;5;12;17;15;24;39
397;Brian Gibbons;PIT;C;41;5;12;17;10;12;22
398;Justin Braun;SJS;D;82;4;13;17;12;26;38
399;Francois Beauchemin;ANA;D;70;4;13;17;12;26;38
400;Eric Brewer;TBL;D;77;4;13;17;12;26;38
401;Sami Salo;TBL;D;71;4;13;17;12;26;38
402;TJ Galiardi;CGY;L;62;4;13;17;8;13;21
403;Tyler Kennedy;SJS;R;67;4;13;17;8;13;21
404;Carl Gunnarsson;TOR;D;80;3;14;17;9;28;37
405;Marco Scandella;MIN;D;76;3;14;17;9;28;37
406;Alexei Emelin;MTL;D;59;3;14;17;9;28;37
407;Andrew Desjardins;SJS;C;81;3;14;17;6;14;20
408;Nate Thompson;TBL;C;81;9;7;16;18;7;25
409;Rene Bourque;MTL;R;63;9;7;16;18;7;25
410;Todd Bertuzzi;DET;R;59;9;7;16;18;7;25
411;Casey Cizikas;NYI;C;80;6;10;16;12;10;22
412;Erik Condra;OTT;R;76;6;10;16;12;10;22
413;Dale Weise;VAN, MTL;R;61;6;10;16;12;10;22
414;Blake Comeau;CBJ;L;61;5;11;16;10;11;21
415;Michal Handzus;CHI;C;59;4;12;16;8;12;20
416;Johnny Oduya;CHI;D;77;3;13;16;9;26;35
417;Michael Del Zotto;NYR, NSH;D;67;3;13;16;9;26;35
418;Calvin de Haan;NYI;D;51;3;13;16;9;26;35
419;Chris Butler;CGY;D;82;2;14;16;6;28;34
420;Matt Donovan;NYI;D;52;2;14;16;6;28;34
421;Ryan Stanton;VAN;D;64;1;15;16;3;30;33
422;Bryan Bickell;CHI;L;59;11;4;15;22;4;26
423;Maxim Lapierre;STL;C;71;9;6;15;18;6;24
424;Brooks Laich;WSH;C;51;8;7;15;16;7;23
425;Tomas Jurco;DET;R;36;8;7;15;16;7;23
426;Drew Miller;DET;L;82;7;8;15;14;8;22
427;Jared Cowen;OTT;D;68;6;9;15;18;18;36
428;Erik Haula;MIN;C;46;6;9;15;12;9;21
429;David Savard;CBJ;D;70;5;10;15;15;20;35
430;Lance Bouma;CGY;C;78;5;10;15;10;10;20
431;Alexandre Burrows;VAN;R;49;5;10;15;10;10;20
432;Ryan Malone;TBL;L;57;5;10;15;10;10;20
433;Ron Hainsey;CAR;D;82;4;11;15;12;22;34
434;John Moore;NYR;D;74;4;11;15;12;22;34
435;Jay Harrison;CAR;D;68;4;11;15;12;22;34
436;Barret Jackman;STL;D;79;3;12;15;9;24;33
437;Paul Martin;PIT;D;39;3;12;15;9;24;33
438;Raphael Diaz;MTL, VAN, NYR;D;63;2;13;15;6;26;32
439;Nikita Nikitin;CBJ;D;66;2;13;15;6;26;32
440;Chris Phillips;OTT;D;70;1;14;15;3;28;31
441;Ville Leino;BUF;L;58;0;15;15;0;15;15
442;Anders Lee;NYI;C;22;9;5;14;18;5;23
443;Matt Martin;NYI;L;79;8;6;14;16;6;22
444;Chris Neil;OTT;R;76;8;6;14;16;6;22
445;Brandon Bollig;CHI;L;82;7;7;14;14;7;21
446;Michael Bournival;MTL;L;60;7;7;14;14;7;21
447;Paul Ranger;TOR;D;53;6;8;14;18;16;34
448;Robyn Regehr;LAK;D;79;3;11;14;9;22;31
449;Marc Staal;NYR;D;72;3;11;14;9;22;31
450;Nicklas Grossmann;PHI;D;78;1;13;14;3;26;29
451;Josh Gorges;MTL;D;66;1;13;14;3;26;29
452;Joe Vitale;PIT;C;53;1;13;14;2;13;15
453;Manny Malhotra;CAR;C;69;7;6;13;14;6;20
454;Brian Flynn;BUF;C;79;6;7;13;12;7;19
455;Brandon Prust;MTL;L;52;6;7;13;12;7;19
456;Cody McLeod;COL;L;71;5;8;13;10;8;18
457;Kyle Quincey;DET;D;82;4;9;13;12;18;30
458;Roman Polak;STL;D;72;4;9;13;12;18;30
459;Tanner Glass;PIT;L;67;4;9;13;8;9;17
460;Richard Panik;TBL;R;50;3;10;13;6;10;16
461;Brooks Orpik;PIT;D;72;2;11;13;6;22;28
462;Mark Stuart;WPG;D;69;2;11;13;6;22;28
463;Anton Stralman;NYR;D;81;1;12;13;3;24;27
464;Mike Weaver;FLA, MTL;D;72;1;12;13;3;24;27
465;Colton Sceviour;DAL;C;26;8;4;12;16;4;20
466;Dave Bolland;TOR;C;23;8;4;12;16;4;20
467;Deryk Engelland;PIT;D;56;6;6;12;18;12;30
468;Magnus Paajarvi;STL;L;55;6;6;12;12;6;18
469;Matt D'Agostini;PIT, BUF;R;57;5;7;12;10;7;17
470;Jeff Halpern;PHX;C;69;5;7;12;10;7;17
471;Luke Schenn;PHI;D;79;4;8;12;12;16;28
472;Tomas Kopecky;FLA;R;49;4;8;12;8;8;16
473;Drayson Bowman;CAR;L;70;4;8;12;8;8;16
474;Scott Hannan;SJS;D;56;3;9;12;9;18;27
475;Steve Bernier;NJD;R;78;3;9;12;6;9;15
476;Dylan Olsen;FLA;D;44;3;9;12;9;18;27
477;Philip Larsen;EDM;D;30;3;9;12;9;18;27
478;Ryan Murphy;CAR;D;48;2;10;12;6;20;26
479;Travis Moen;MTL;L;65;2;10;12;4;10;14
480;Grant Clitsome;WPG;D;32;2;10;12;6;20;26
481;Scott Gomez;FLA;C;46;2;10;12;4;10;14
482;Willie Mitchell;LAK;D;76;1;11;12;3;22;25
483;Emerson Etem;ANA;L;29;7;4;11;14;4;18
484;Trevor Lewis;LAK;C;73;6;5;11;12;5;17
485;Patrick Bordeleau;COL;L;82;6;5;11;12;5;17
486;Peter Holland;ANA, TOR;C;43;6;5;11;12;5;17
487;Craig Adams;PIT;R;82;5;6;11;10;6;16
488;David Clarkson;TOR;R;60;5;6;11;10;6;16
489;Jeremy Morin;CHI;R;24;5;6;11;10;6;16
490;Mark Fayne;NJD;D;72;4;7;11;12;14;26
491;Stephen Gionta;NJD;C;66;4;7;11;8;7;15
492;Peter Regin;NYI, CHI;C;61;4;7;11;8;7;15
493;Michael Kostka;CHI, TBL;D;28;4;7;11;12;14;26
494;Alex Tanguay;COL;L;16;4;7;11;8;7;15
495;Zach Bogosian;WPG;D;55;3;8;11;9;16;25
496;Brad Stuart;SJS;D;61;3;8;11;9;16;25
497;Dmitry Orlov;WSH;D;54;3;8;11;9;16;25
498;Ian Cole;STL;D;46;3;8;11;9;16;25
499;Lubomir Visnovsky;NYI;D;24;3;8;11;9;16;25
500;Jon Merrill;NJD;D;52;2;9;11;6;18;24
501;Eric Gryba;OTT;D;57;2;9;11;6;18;24
502;Chris Thorburn;WPG;R;55;2;9;11;4;9;13
503;Corey Tropp;BUF, CBJ;R;53;2;9;11;4;9;13
504;Sven Baertschi;CGY;L;26;2;9;11;4;9;13
505;Jonathan Ericsson;DET;D;48;1;10;11;3;20;23
506;Ryan Spooner;BOS;C;23;0;11;11;0;11;11
507;Ryan Carter;NJD;L;62;7;3;10;14;3;17
508;Yannick Weber;VAN;D;49;6;4;10;18;8;26
509;Jordan Nolan;LAK;C;64;6;4;10;12;4;16
510;Stephane Robidas;DAL, ANA;D;38;5;5;10;15;10;25
511;Mark Barberio;TBL;D;49;5;5;10;15;10;25
512;Matt Halischuk;WPG;R;46;5;5;10;10;5;15
513;Jay McClement;TOR;C;81;4;6;10;8;6;14
514;Tom Wilson;WSH;R;82;3;7;10;6;7;13
515;B.J. Crombeen;TBL;R;55;3;7;10;6;7;13
516;Joe Corvo;OTT;D;25;3;7;10;9;14;23
517;Troy Bodie;TOR;R;47;3;7;10;6;7;13
518;Zbynek Michalek;PHX;D;59;2;8;10;6;16;22
519;Torrey Mitchell;MIN, BUF;C;67;2;8;10;4;8;12
520;Erik Gustafsson;PHI;D;31;2;8;10;6;16;22
521;Steve Oleksy;WSH;D;33;2;8;10;6;16;22
522;Devante Smith-Pelly;ANA;R;19;2;8;10;4;8;12
523;Cory Sarich;COL;D;54;1;9;10;3;18;21
524;Dennis Seidenberg;BOS;D;34;1;9;10;3;18;21
525;Bryan Allen;ANA;D;68;0;10;10;0;20;20
526;Robert Bortuzzo;PIT;D;54;0;10;10;0;20;20
527;Tom Sestito;VAN;L;77;5;4;9;10;4;14
528;Jayson Megna;PIT;C;36;5;4;9;10;4;14
529;Adam Hall;PHI;R;80;4;5;9;8;5;13
530;Jay Beagle;WSH;R;62;4;5;9;8;5;13
531;Radek Dvorak;CAR;R;60;4;5;9;8;5;13
532;Pierre-Marc Bouchard;NYI;C;28;4;5;9;8;5;13
533;Trevor Smith;TOR;C;28;4;5;9;8;5;13
534;Erik Gudbranson;FLA;D;65;3;6;9;9;12;21
535;Brian Strait;NYI;D;47;3;6;9;9;12;21
536;Cody Ceci;OTT;D;49;3;6;9;9;12;21
537;Evgeny Kuznetsov;WSH;C;17;3;6;9;6;6;12
538;Kevin Klein;NSH, NYR;D;77;2;7;9;6;14;20
539;John-Michael Liles;TOR, CAR;D;41;2;7;9;6;14;20
540;Keith Ballard;MIN;D;45;2;7;9;6;14;20
541;Calle Jarnkrok;NSH;C;12;2;7;9;4;7;11
542;Mike Weber;BUF;D;68;1;8;9;3;16;19
543;Nate Guenin;COL;D;68;1;8;9;3;16;19
544;Mattias Ekholm;NSH;D;62;1;8;9;3;16;19
545;David Schlemko;PHX;D;48;1;8;9;3;16;19
546;Shawn Thornton;BOS;L;64;5;3;8;10;3;13
547;Vincent Trocheck;FLA;C;20;5;3;8;10;3;13
548;Daniel Cleary;DET;R;52;4;4;8;8;4;12
549;Derek Dorsett;NYR;R;51;4;4;8;8;4;12
550;Brian McGrattan;CGY;R;76;4;4;8;8;4;12
551;Mark Stone;OTT;R;19;4;4;8;8;4;12
552;Kyle Clifford;LAK;L;71;3;5;8;6;5;11
553;Ladislav Smid;EDM, CGY;D;73;2;6;8;6;12;18
554;Henrik Tallinder;BUF;D;64;2;6;8;6;12;18
555;Brett Bellemore;CAR;D;64;2;6;8;6;12;18
556;Nate Prosser;MIN;D;53;2;6;8;6;12;18
557;Ryan Reaves;STL;R;63;2;6;8;4;6;10
558;Tim Kennedy;PHX;L;37;2;6;8;4;6;10
559;Paul Bissonnette;PHX;L;39;2;6;8;4;6;10
560;Michal Rozsival;CHI;D;42;1;7;8;3;14;17
561;Andrej Sustr;TBL;D;43;1;7;8;3;14;17
562;Kevin Connauton;DAL;D;36;1;7;8;3;14;17
563;Connor Murphy;PHX;D;30;1;7;8;3;14;17
564;Anton Volchenkov;NJD;D;56;0;8;8;0;16;16
565;Matt Hendricks;NSH, EDM;C;77;5;2;7;10;2;12
566;Drew Shore;FLA;C;24;5;2;7;10;2;12
567;Zac Dalpe;VAN;C;55;4;3;7;8;3;11
568;Kevin Westgarth;CAR, CGY;R;48;4;3;7;8;3;11
569;Rich Clune;NSH;L;58;3;4;7;6;4;10
570;Tom Pyatt;TBL;C;27;3;4;7;6;4;10
571;Beau Bennett;PIT;R;21;3;4;7;6;4;10
572;Eric O'Dell;WPG;C;30;3;4;7;6;4;10
573;Tanner Pearson;LAK;L;25;3;4;7;6;4;10
574;Sheldon Brookbank;CHI;D;48;2;5;7;6;10;16
575;Matt Frattin;LAK, CBJ;R;44;2;5;7;4;5;9
576;Cody McCormick;BUF, MIN;C;43;2;5;7;4;5;9
577;Reid Boucher;NJD;R;23;2;5;7;4;5;9
578;Anton Belov;EDM;D;57;1;6;7;3;12;15
579;Mark Pysyk;BUF;D;44;1;6;7;3;12;15
580;Marc-Andre Cliche;COL;C;76;1;6;7;2;6;8
581;Luke Glendening;DET;C;56;1;6;7;2;6;8
582;Matt Ellis;BUF;L;50;4;2;6;8;2;10
583;Quinton Howden;FLA;C;16;4;2;6;8;2;10
584;Eric Tangradi;WPG;L;55;3;3;6;6;3;9
585;J.T. Miller;NYR;C;30;3;3;6;6;3;9
586;Mike Hoffman;OTT;L;25;3;3;6;6;3;9
587;Jordan Schroeder;VAN;C;25;3;3;6;6;3;9
588;Nicklas Jensen;VAN;R;17;3;3;6;6;3;9
589;Francis Bouillon;MTL;D;52;2;4;6;6;8;14
590;Dalton Prout;CBJ;D;49;2;4;6;6;8;14
591;Keaton Ellerby;WPG;D;51;2;4;6;6;8;14
592;Matt Greene;LAK;D;38;2;4;6;6;8;14
593;Nate Schmidt;WSH;D;29;2;4;6;6;8;14
594;Ryan Jones;EDM;L;52;2;4;6;4;4;8
595;Ryan White;MTL;C;52;2;4;6;4;4;8
596;Brandon McMillan;PHX;C;22;2;4;6;4;4;8
597;Brian Lashoff;DET;D;75;1;5;6;3;10;13
598;Tim Gleason;CAR, TOR;D;56;1;5;6;3;10;13
599;Kevan Miller;BOS;D;47;1;5;6;3;10;13
600;Victor Bartley;NSH;D;50;1;5;6;3;10;13
601;Connor Carrick;WSH;D;34;1;5;6;3;10;13
602;Luca Sbisa;ANA;D;30;1;5;6;3;10;13
603;Adam McQuaid;BOS;D;30;1;5;6;3;10;13
604;Jordan Leopold;STL;D;27;1;5;6;3;10;13
605;Adam Pardy;WPG;D;60;0;6;6;0;12;12
606;Martin Marincin;EDM;D;44;0;6;6;0;12;12
607;Ryan Wilson;COL;D;28;0;6;6;0;12;12
608;Taylor Pyatt;NYR, PIT;L;56;4;1;5;8;1;9
609;Daniel Carcillo;LAK, NYR;L;57;4;1;5;8;1;9
610;Jason Zucker;MIN;L;21;4;1;5;8;1;9
611;Tim Jackman;CGY, ANA;R;36;4;1;5;8;1;9
612;Chris Conner;PIT;R;19;4;1;5;8;1;9
613;Tye McGinn;PHI;L;18;4;1;5;8;1;9
614;Jesse Joensuu;EDM;L;42;3;2;5;6;2;8
615;Bracken Kearns;SJS;L;25;3;2;5;6;2;8
616;Will Acton;EDM;C;30;3;2;5;6;2;8
617;Brad Malone;COL;C;32;3;2;5;6;2;8
618;Raffi Torres;SJS;L;5;3;2;5;6;2;8
619;Mike Brown;EDM, SJS;R;56;2;3;5;4;3;7
620;Patrick Eaves;DET, NSH;R;30;2;3;5;4;3;7
621;Anthony Peluso;WPG;R;53;2;3;5;4;3;7
622;Clayton Stoner;MIN;D;63;1;4;5;3;8;11
623;Ed Jovanovski;FLA;D;37;1;4;5;3;8;11
624;Mark Fistric;ANA;D;34;1;4;5;3;8;11
625;Filip Forsberg;NSH;C;13;1;4;5;2;4;6
626;Nick Schultz;EDM, CBJ;D;69;0;5;5;0;10;10
627;Simon Despres;PIT;D;34;0;5;5;0;10;10
628;Corey Potter;EDM, BOS;D;19;0;5;5;0;10;10
629;Linden Vey;LAK;R;18;0;5;5;0;5;5
630;Jack Skille;CBJ;R;16;4;0;4;8;0;8
631;Stephane Da Costa;OTT;C;12;3;1;4;6;1;7
632;Rasmus Ristolainen;BUF;D;34;2;2;4;6;4;10
633;Zac Rinaldo;PHI;C;67;2;2;4;4;2;6
634;Luke Gazdic;EDM;L;67;2;2;4;4;2;6
635;Stephen Weiss;DET;C;26;2;2;4;4;2;6
636;Dustin Jeffrey;PIT, DAL;C;34;2;2;4;4;2;6
637;Eric Boulton;NYI;L;23;2;2;4;4;2;6
638;Bryce Salvador;NJD;D;40;1;3;4;3;6;9
639;John Erskine;WSH;D;37;1;3;4;3;6;9
640;Rostislav Klesla;PHX;D;25;1;3;4;3;6;9
641;Carlo Colaiacovo;STL;D;25;1;3;4;3;6;9
642;Colton Sissons;NSH;C;17;1;3;4;2;3;5
643;Michael Latta;WSH;C;17;1;3;4;2;3;5
644;Zach Boychuk;CAR;L;11;1;3;4;2;3;5
645;Rob Scuderi;PIT;D;53;0;4;4;0;8;8
646;Peter Harrold;NJD;D;33;0;4;4;0;8;8
647;Johan Larsson;BUF;L;28;0;4;4;0;4;4
648;Mike Komisarek;CAR;D;32;0;4;4;0;8;8
649;Krys Barch;FLA;R;55;0;4;4;0;4;4
650;Rickard Rakell;ANA;C;18;0;4;4;0;4;4
651;Jean-Philippe Cote;TBL;D;19;0;4;4;0;8;8
652;Tyler Wotherspoon;CGY;D;14;0;4;4;0;8;8
653;Stephane Veilleux;MIN;L;34;3;0;3;6;0;6
654;Jordan Szwarz;PHX;R;26;3;0;3;6;0;6
655;Cam Janssen;NJD;R;24;3;0;3;6;0;6
656;Chris Summers;PHX;D;18;2;1;3;6;2;8
657;Mikhail Grigorenko;BUF;C;18;2;1;3;4;1;5
658;Casey Wellman;WSH;C;13;2;1;3;4;1;5
659;Markus Granlund;CGY;C;7;2;1;3;4;1;5
660;Zenon Konopka;MIN, BUF;C;59;1;2;3;2;2;4
661;Adam Larsson;NJD;D;26;1;2;3;3;4;7
662;Jordan Caron;BOS;R;35;1;2;3;2;2;4
663;Paul Postma;WPG;D;20;1;2;3;3;4;7
664;Aaron Ness;NYI;D;20;1;2;3;3;4;7
665;Jacob Josefson;NJD;C;27;1;2;3;2;2;4
666;Mikael Samuelsson;DET;R;26;1;2;3;2;2;4
667;Oscar Klefbom;EDM;D;17;1;2;3;3;4;7
668;Joakim Nordstrom;CHI;C;16;1;2;3;2;2;4
669;Jerry D'Amigo;TOR;R;22;1;2;3;2;2;4
670;Zach Redmond;WPG;D;10;1;2;3;3;4;7
671;Darren Archibald;VAN;R;16;1;2;3;2;2;4
672;Matt Carkner;NYI;D;53;0;3;3;0;6;6
673;Shane O'Brien;CGY;D;45;0;3;3;0;6;6
674;Radek Martinek;NYI;D;13;0;3;3;0;6;6
675;Carter Ashton;TOR;R;32;0;3;3;0;3;3
676;Tim Sestito;NJD;L;16;0;3;3;0;3;3
677;Patrick Wey;WSH;D;9;0;3;3;0;6;6
678;Chad Billins;CGY;D;10;0;3;3;0;6;6
679;Patrice Cormier;WPG;C;9;0;3;3;0;3;3
680;Chuck Kobasew;PIT;R;33;2;0;2;4;0;4
681;Aaron Volpatti;WSH;L;41;2;0;2;4;0;4
682;Jean-Gabriel Pageau;OTT;C;28;2;0;2;4;0;4
683;Jay Rosehill;PHI;L;34;2;0;2;4;0;4
684;Blair Jones;CGY;C;14;2;0;2;4;0;4
685;Matt Fraser;BOS;R;14;2;0;2;4;0;4
686;Harry Zolnierczyk;PIT;L;13;2;0;2;4;0;4
687;Taylor Fedun;EDM;D;4;2;0;2;6;0;6
688;Alex Grant;ANA;D;2;2;0;2;6;0;6
689;Mark Fraser;TOR, EDM;D;42;1;1;2;3;2;5
690;John McCarthy;SJS;L;36;1;1;2;2;1;3
691;Alexander Urbom;WSH;D;20;1;1;2;3;2;5
692;Jim Slater;WPG;C;27;1;1;2;2;1;3
693;Matt Gilroy;FLA;D;16;1;1;2;3;2;5
694;Jared Boll;CBJ;R;28;1;1;2;2;1;3
695;Dmitrij Jaskin;STL;R;18;1;1;2;2;1;3
696;Matt Dumba;MIN;D;13;1;1;2;3;2;5
697;Julien Brouillette;WSH;D;10;1;1;2;3;2;5
698;Matt Kassian;OTT;L;33;1;1;2;2;1;3
699;Brett Sutter;CAR;L;17;1;1;2;2;1;3
700;Chris Brown;PHX, WSH;C;12;1;1;2;2;1;3
701;Philip Varone;BUF;C;9;1;1;2;2;1;3
702;David Warsofsky;BOS;D;6;1;1;2;3;2;5
703;Kenny Agostino;CGY;L;8;1;1;2;2;1;3
704;Josh Leivo;TOR;L;7;1;1;2;2;1;3
705;Simon Moser;NSH;C;6;1;1;2;2;1;3
706;Justin Florek;BOS;L;4;1;1;2;2;1;3
707;Douglas Murray;MTL;D;53;0;2;2;0;4;4
708;James Wright;WPG;C;59;0;2;2;0;2;2
709;Alexander Sulzer;BUF;D;25;0;2;2;0;4;4
710;Jarred Tinordi;MTL;D;22;0;2;2;0;4;4
711;Tyson Strachan;WSH;D;18;0;2;2;0;4;4
712;Colby Robak;FLA;D;16;0;2;2;0;4;4
713;Colin Fraser;LAK;C;33;0;2;2;0;2;2
714;Kevin Czuczman;NYI;D;13;0;2;2;0;4;4
715;Justin Falk;NYR;D;21;0;2;2;0;4;4
716;Nathan Beaulieu;MTL;D;17;0;2;2;0;4;4
717;Derek Grant;OTT;C;20;0;2;2;0;2;2
718;Linus Omark;EDM, BUF;L;14;0;2;2;0;2;2
719;Cory Emmerton;DET;C;18;0;2;2;0;2;2
720;Adam Cracknell;STL;R;19;0;2;2;0;2;2
721;Chris Terry;CAR;L;10;0;2;2;0;2;2
722;Rostislav Olesz;NJD;L;10;0;2;2;0;2;2
723;Max Reinhart;CGY;C;8;0;2;2;0;2;2
724;Chris Breen;CGY;D;9;0;2;2;0;4;4
725;Ben Hanowski;CGY;R;11;0;2;2;0;2;2
726;Andy Miele;PHX;C;7;0;2;2;0;2;2
727;Steven Pinizzotto;EDM;R;6;0;2;2;0;2;2
728;Lane MacDermid;DAL, CGY;L;7;0;2;2;0;2;2
729;John Scott;BUF;L;56;1;0;1;2;0;2
730;Nicolas Deslauriers;BUF;L;17;1;0;1;2;0;2
731;Mike Halmo;NYI;L;20;1;0;1;2;0;2
732;Frank Corrado;VAN;D;15;1;0;1;3;0;3
733;Mark Borowiecki;OTT;D;13;1;0;1;3;0;3
734;Luke Adam;BUF;C;12;1;0;1;2;0;2
735;Mattias Tedenby;NJD;R;15;1;0;1;2;0;2
736;Brett Connolly;TBL;R;11;1;0;1;2;0;2
737;Jeremy Welsh;VAN;C;19;1;0;1;2;0;2
738;John Persson;NYI;L;10;1;0;1;2;0;2
739;Nikita Zadorov;BUF;D;7;1;0;1;3;0;3
740;Eriah Hayes;SJS;R;15;1;0;1;2;0;2
741;Tyler Pitlick;EDM;R;10;1;0;1;2;0;2
742;Corban Knight;CGY;C;7;1;0;1;2;0;2
743;Kellan Lain;VAN;C;9;1;0;1;2;0;2
744;John Albert;WPG;C;9;1;0;1;2;0;2
745;Adam Almquist;DET;D;2;1;0;1;3;0;3
746;Roman Horak;CGY, EDM;C;3;1;0;1;2;0;2
747;Carl Klingberg;WPG;L;3;1;0;1;2;0;2
748;Matt Pelech;SJS;R;6;1;0;1;2;0;2
749;Matt Carey;CHI;L;2;1;0;1;2;0;2
750;Stefan Elliott;COL;D;1;1;0;1;3;0;3
751;Johnny Gaudreau;CGY;L;1;1;0;1;2;0;2
752;Chad Ruhwedel;BUF;D;21;0;1;1;0;2;2
753;Anton Lander;EDM;C;27;0;1;1;0;1;1
754;Aaron Rome;DAL;D;25;0;1;1;0;2;2
755;Jack Hillen;WSH;D;13;0;1;1;0;2;2
756;David Rundblad;PHX, CHI;D;17;0;1;1;0;2;2
757;Chris Porter;STL;L;22;0;1;1;0;1;1
758;Jonathon Blum;MIN;D;15;0;1;1;0;2;2
759;Michael Chaput;CBJ;C;17;0;1;1;0;1;1
760;Keith Aulie;TBL;D;15;0;1;1;0;2;2
761;Kevin Porter;BUF;C;12;0;1;1;0;1;1
762;Chris VandeVelde;PHI;C;18;0;1;1;0;1;1
763;Ben Street;CGY;C;13;0;1;1;0;1;1
764;Derek Smith;CGY;D;14;0;1;1;0;2;2
765;Joey Crabb;FLA;R;9;0;1;1;0;1;1
766;Brian Dumoulin;PIT;D;6;0;1;1;0;2;2
767;Jake McCabe;BUF;D;7;0;1;1;0;2;2
768;George Parros;MTL;R;22;0;1;1;0;1;1
769;Andrew Ebbett;PIT;C;9;0;1;1;0;1;1
770;Denis Grebeshkov;EDM;D;7;0;1;1;0;2;2
771;Johan Sundstrom;NYI;C;11;0;1;1;0;1;1
772;Alex Petrovic;FLA;D;7;0;1;1;0;2;2
773;Mike Rupp;MIN;L;13;0;1;1;0;1;1
774;Jordin Tootoo;DET;R;11;0;1;1;0;1;1
775;Ben Eager;EDM;L;7;0;1;1;0;1;1
776;Sean Collins;CBJ;C;6;0;1;1;0;1;1
777;Travis Morin;DAL;C;4;0;1;1;0;1;1
778;David Broll;TOR;L;5;0;1;1;0;1;1
779;Dmitry Korobov;TBL;D;3;0;1;1;0;2;2
780;Nolan Yonkman;ANA;D;2;0;1;1;0;2;2
781;Cedric Paquette;TBL;C;2;0;1;1;0;1;1
782;Bobby Butler;FLA;R;2;0;1;1;0;1;1
783;Michael Zalewski;VAN;L;2;0;1;1;0;1;1
784;Kris Newbury;PHI;C;4;0;1;1;0;1;1
785;Christian Folin;MIN;D;1;0;1;1;0;2;2
786;Maxime Fortunus;DAL;D;1;0;1;1;0;2;2
787;Jason Akeson;PHI;R;1;0;1;1;0;1;1
788;Colton Orr;TOR;R;54;0;0;0;0;0;0
789;Zach Sill;PIT;C;20;0;0;0;0;0;0
790;Brayden McNabb;BUF;D;12;0;0;0;0;0;0
791;Jerred Smithson;TOR;C;18;0;0;0;0;0;0
792;Adam Burish;SJS;R;15;0;0;0;0;0;0
793;Cameron Gaunce;DAL;D;9;0;0;0;0;0;0
794;Jamie Oleksiak;DAL;D;7;0;0;0;0;0;0
795;Jesper Fast;NYR;R;11;0;0;0;0;0;0
796;Mike Sislo;NJD;R;14;0;0;0;0;0;0
797;Ryan Whitney;FLA;D;7;0;0;0;0;0;0
798;Freddie Hamilton;SJS;C;11;0;0;0;0;0;0
799;Patrik Nemeth;DAL;D;8;0;0;0;0;0;0
800;Frazer McLaren;TOR;L;27;0;0;0;0;0;0
801;Mike Mottau;FLA;D;8;0;0;0;0;0;0
802;Matt Taormina;TBL;D;7;0;0;0;0;0;0
803;Taylor Beck;NSH;L;7;0;0;0;0;0;0
804;Pierre-Cedric Labrie;TBL;L;13;0;0;0;0;0;0
805;Hal Gill;PHI;D;6;0;0;0;0;0;0
806;Nick Johnson;BOS;R;9;0;0;0;0;0;0
807;Scott Mayfield;NYI;D;5;0;0;0;0;0;0
808;Chris Mueller;DAL;C;9;0;0;0;0;0;0
809;Louis Leblanc;MTL;C;8;0;0;0;0;0;0
810;Philip Samuelsson;PIT;D;5;0;0;0;0;0;0
811;Paul Carey;COL;C;12;0;0;0;0;0;0
812;Andrew Alberts;VAN;D;10;0;0;0;0;0;0
813;Brandon Gormley;PHX;D;5;0;0;0;0;0;0
814;David Steckel;ANA;C;6;0;0;0;0;0;0
815;Dana Tyrell;TBL;C;7;0;0;0;0;0;0
816;Xavier Ouellet;DET;D;4;0;0;0;0;0;0
817;Bryce Van Brabant;CGY;L;6;0;0;0;0;0;0
818;Brett Bulmer;MIN;R;5;0;0;0;0;0;0
819;Cody Goloubef;CBJ;D;5;0;0;0;0;0;0
820;Arron Asham;NYR;R;6;0;0;0;0;0;0
821;Conor Allen;NYR;D;3;0;0;0;0;0;0
822;Mark Cundari;CGY;D;4;0;0;0;0;0;0
823;Mike Blunden;MTL;R;7;0;0;0;0;0;0
824;Teuvo Teravainen;CHI;C;3;0;0;0;0;0;0
825;Ryan Craig;CBJ;C;6;0;0;0;0;0;0
826;Patrick Kaleta;BUF;R;5;0;0;0;0;0;0
827;Patrick Holland;MTL;R;5;0;0;0;0;0;0
828;Andrew Campbell;LAK;D;3;0;0;0;0;0;0
829;Vladislav Namestnikov;TBL;C;4;0;0;0;0;0;0
830;Brad Hunt;EDM;D;3;0;0;0;0;0;0
831;Yann Sauve;VAN;D;3;0;0;0;0;0;0
832;Landon Ferraro;DET;C;4;0;0;0;0;0;0
833;Gilbert Brule;PHX;C;3;0;0;0;0;0;0
834;Lucas Lessio;PHX;L;3;0;0;0;0;0;0
835;Garrett Wilson;FLA;L;3;0;0;0;0;0;0
836;Brad Mills;CHI;C;3;0;0;0;0;0;0
837;Zach Trotman;BOS;D;2;0;0;0;0;0;0
838;Tim Erixon;CBJ;D;2;0;0;0;0;0;0
839;Brett Gallant;NYI;L;4;0;0;0;0;0;0
840;Brandon Mashinter;NYR;L;6;0;0;0;0;0;0
841;Ryan Stoa;WSH;C;3;0;0;0;0;0;0
842;Pascal Pelletier;VAN;L;3;0;0;0;0;0;0
843;Keith Aucoin;STL;C;2;0;0;0;0;0;0
844;Joe Piskula;NSH;D;2;0;0;0;0;0;0
845;Matt Lindblad;BOS;C;2;0;0;0;0;0;0
846;Teemu Pulkkinen;DET;L;3;0;0;0;0;0;0
847;Ty Rattie;STL;R;2;0;0;0;0;0;0
848;Nicolas Deschamps;WSH;C;3;0;0;0;0;0;0
849;Ryan Hamilton;EDM;L;2;0;0;0;0;0;0
850;Craig Cunningham;BOS;R;2;0;0;0;0;0;0
851;Aaron Palushaj;CAR;R;2;0;0;0;0;0;0
852;Ryan Sproul;DET;D;1;0;0;0;0;0;0
853;Adam Payerl;PIT;C;2;0;0;0;0;0;0
854;Cameron Schilling;WSH;D;1;0;0;0;0;0;0
855;Matt Hunwick;COL;D;1;0;0;0;0;0;0
856;Jonathan Racine;FLA;D;1;0;0;0;0;0;0
857;Alexander Khokhlachev;BOS;C;1;0;0;0;0;0;0
858;Christian Thomas;MTL;L;2;0;0;0;0;0;0
859;Dylan McIlrath;NYR;D;2;0;0;0;0;0;0
860;Brandon Yip;PHX;R;2;0;0;0;0;0;0
861;Gabriel Dumont;MTL;C;2;0;0;0;0;0;0
862;Bill Arnold;CGY;C;1;0;0;0;0;0;0
863;Alexey Marchenko;DET;D;1;0;0;0;0;0;0
864;Karl Stollery;COL;D;2;0;0;0;0;0;0
865;Justin Johnson;NYI;R;2;0;0;0;0;0;0
866;Petter Granberg;TOR;D;1;0;0;0;0;0;0
867;Jamie Devane;TOR;L;2;0;0;0;0;0;0
868;David Van Der Gulik;COL;L;2;0;0;0;0;0;0
869;Ben Chiarot;WPG;D;1;0;0;0;0;0;0
870;Nick Drazenovic;PIT;C;1;0;0;0;0;0;0
871;Cody Kunyk;TBL;R;1;0;0;0;0;0;0
872;Martin St Pierre;MTL;C;1;0;0;0;0;0;0
873;Peter LeBlanc;WSH;C;1;0;0;0;0;0;0
874;Mitch Callahan;DET;R;1;0;0;0;0;0;0
875;Benn Ferriero;VAN;R;2;0;0;0;0;0;0
876;Julian Melchiori;WPG;D;1;0;0;0;0;0;0
877;Darroll Powe;NYR;C;1;0;0;0;0;0;0
878;Mark Van Guilder;NSH;C;1;0;0;0;0;0;0
879;Carson McMillan;MIN;R;1;0;0;0;0;0;0
880;Joe Whitney;NJD;R;1;0;0;0;0;0;0
881;Jake Dowell;MIN;C;1;0;0;0;0;0;0
882;Spencer Abbott;TOR;L;1;0;0;0;0;0;0
883;Pierre-Luc Letourneau-Leblond;PIT;R;1;0;0;0;0;0;0
884;Greg McKegg;TOR;C;1;0;0;0;0;0;0
885;Cody Bass;CBJ;C;1;0;0;0;0;0;0
886;Joonas Nattinen;MTL;C;1;0;0;0;0;0;0
