rank;name;old_team;pos;gp;goals;assists;points;f_goals;f_assists;f_points
1;Martin St Louis;TBL;R;48;17;43;60;34;43;77
2;Steven Stamkos;TBL;C;48;29;28;57;58;28;86
3;Alex Ovechkin;WSH;L;48;32;24;56;64;24;88
4;Sidney Crosby;PIT;C;36;15;41;56;30;41;71
5;Patrick Kane;CHI;R;47;23;32;55;46;32;78
6;Eric Staal;CAR;C;48;18;35;53;36;35;71
7;Chris Kunitz;PIT;L;48;22;30;52;44;30;74
8;Phil Kessel;TOR;C;48;20;32;52;40;32;72
9;Taylor Hall;EDM;L;45;16;34;50;32;34;66
10;Pavel Datsyuk;DET;C;47;15;34;49;30;34;64
11;Ryan Getzlaf;ANA;C;44;15;34;49;30;34;64
12;Mike Ribeiro;WSH;C;48;13;36;49;26;36;62
13;Jonathan Toews;CHI;C;47;23;25;48;46;25;71
14;Claude Giroux;PHI;R;48;13;35;48;26;35;61
15;Henrik Zetterberg;DET;L;46;11;37;48;22;37;59
16;Nicklas Backstrom;WSH;C;48;8;40;48;16;40;56
17;John Tavares;NYI;C;48;28;19;47;56;19;75
18;Jakub Voracek;PHI;R;48;22;24;46;44;24;68
19;Andrew Ladd;WPG;L;48;18;28;46;36;28;64
20;Henrik Sedin;VAN;C;48;11;34;45;22;34;56
21;Derek Stepan;NYR;C;48;18;26;44;36;26;62
22;Nazem Kadri;TOR;C;48;18;26;44;36;26;62
23;Matt Moulson;NYI;L;47;15;29;44;30;29;59
24;Alexander Semin;CAR;R;44;13;31;44;26;31;57
25;PA Parenteau;COL;R;48;18;25;43;36;25;61
26;Matt Duchene;COL;C;47;17;26;43;34;26;60
27;Rick Nash;NYR;L;44;21;21;42;42;21;63
28;Anze Kopitar;LAK;C;47;10;32;42;20;32;52
29;Thomas Vanek;BUF;L;38;20;21;41;40;21;61
30;Blake Wheeler;WPG;R;48;19;22;41;38;22;60
31;Daniel Sedin;VAN;L;47;12;28;40;24;28;52
32;Joe Thornton;SJS;C;48;7;33;40;14;33;47
33;Max Pacioretty;MTL;L;44;15;24;39;30;24;54
34;Jiri Tlusty;CAR;C;48;23;15;38;46;15;61
35;Pascal Dupuis;PIT;L;48;20;18;38;40;18;58
36;Zach Parise;MIN;L;48;18;20;38;36;20;56
37;Sam Gagner;EDM;C;48;14;24;38;28;24;52
38;P.K. Subban;MTL;D;42;11;27;38;33;54;87
39;Kris Letang;PIT;D;35;5;33;38;15;66;81
40;Logan Couture;SJS;C;48;21;16;37;42;16;58
41;Jordan Eberle;EDM;C;48;16;21;37;32;21;53
42;Mikko Koivu;MIN;C;48;11;26;37;22;26;48
43;James Neal;PIT;L;40;21;15;36;42;15;57
44;Brad Marchand;BOS;C;45;18;18;36;36;18;54
45;Chris Stewart;STL;R;48;18;18;36;36;18;54
46;Corey Perry;ANA;R;44;15;21;36;30;21;51
47;Patrik Elias;NJD;L;48;14;22;36;28;22;50
48;Teddy Purcell;TBL;R;48;11;25;36;22;25;47
49;Jaromir Jagr;DAL, BOS;R;45;16;19;35;32;19;51
50;Michael Ryder;DAL, MTL;R;46;16;19;35;32;19;51
51;Tomas Fleischmann;FLA;L;48;12;23;35;24;23;47
52;Brad Boyes;NYI;R;48;10;25;35;20;25;45
53;Cody Hodgson;BUF;C;48;15;19;34;30;19;49
54;Jason Pominville;BUF, MIN;R;47;14;20;34;28;20;48
55;Brad Richards;NYR;C;46;11;23;34;22;23;45
56;Jeff Carter;LAK;C;48;26;7;33;52;7;59
57;Troy Brouwer;WSH;R;47;19;14;33;38;14;52
58;Evander Kane;WPG;L;48;17;16;33;34;16;50
59;Tomas Plekanec;MTL;C;47;14;19;33;28;19;47
60;Jarome Iginla;CGY, PIT;R;44;14;19;33;28;19;47
61;Jamie Benn;DAL;L;41;12;21;33;24;21;45
62;Justin Williams;LAK;R;48;11;22;33;22;22;44
63;David Krejci;BOS;C;47;10;23;33;20;23;43
64;Evgeni Malkin;PIT;C;31;9;24;33;18;24;42
65;James van Riemsdyk;TOR;L;48;18;14;32;36;14;50
66;Tyler Seguin;BOS;C;48;16;16;32;32;16;48
67;Wayne Simmonds;PHI;R;45;15;17;32;30;17;47
68;Mike Cammalleri;CGY;L;44;13;19;32;26;19;45
69;Mike Richards;LAK;C;48;12;20;32;24;20;44
70;Patrice Bergeron;BOS;C;42;10;22;32;20;22;42
71;Vincent Lecavalier;TBL;C;39;10;22;32;20;22;42
72;Lee Stempniak;CGY;R;47;9;23;32;18;23;41
73;Bryan Little;WPG;R;48;7;25;32;14;25;39
74;Ryan Suter;MIN;D;48;4;28;32;12;56;68
75;Patrick Marleau;SJS;C;48;17;14;31;34;14;48
76;Marian Hossa;CHI;R;40;17;14;31;34;14;48
77;Nail Yakupov;EDM;R;48;17;14;31;34;14;48
78;Ryan Callahan;NYR;R;45;16;15;31;32;15;47
79;Joe Pavelski;SJS;C;48;16;15;31;32;15;47
80;Jonathan Huberdeau;FLA;C;48;14;17;31;28;17;45
81;Johan Franzen;DET;C;41;14;17;31;28;17;45
82;Ilya Kovalchuk;NJD;L;37;11;20;31;22;20;42
83;Jordan Staal;CAR;C;48;10;21;31;20;21;41
84;Tyler Ennis;BUF;C;47;10;21;31;20;21;41
85;Vinny Prospal;CBJ;L;48;12;18;30;24;18;42
86;Bobby Ryan;ANA;R;46;11;19;30;22;19;41
87;Andrei Markov;MTL;D;48;10;20;30;30;40;70
88;Keith Yandle;PHX;D;48;10;20;30;30;40;70
89;Lars Eller;MTL;C;46;8;22;30;16;22;38
90;Dustin Brown;LAK;L;46;18;11;29;36;11;47
91;Loui Eriksson;DAL;L;48;12;17;29;24;17;41
92;Kyle Turris;OTT;C;48;12;17;29;24;17;41
93;Derick Brassard;CBJ, NYR;C;47;12;17;29;24;17;41
94;Cory Conacher;TBL, OTT;C;47;11;18;29;22;18;40
95;Ray Whitney;DAL;L;32;11;18;29;22;18;40
96;Frans Nielsen;NYI;C;48;6;23;29;12;23;35
97;Niklas Kronwall;DET;D;48;5;24;29;15;48;63
98;Kimmo Timonen;PHI;D;45;5;24;29;15;48;63
99;Cody Franson;TOR;D;45;4;25;29;12;50;62
100;Brendan Gallagher;MTL;R;44;15;13;28;30;13;43
101;Tyler Bozak;TOR;C;46;12;16;28;24;16;40
102;Radim Vrbata;PHX;R;34;12;16;28;24;16;40
103;David Desharnais;MTL;C;48;10;18;28;20;18;38
104;Shea Weber;NSH;D;48;9;19;28;27;38;65
105;Dion Phaneuf;TOR;D;48;9;19;28;27;38;65
106;Dustin Byfuglien;WPG;D;43;8;20;28;24;40;64
107;Derek Roy;DAL, VAN;C;42;7;21;28;14;21;35
108;David Backes;STL;R;48;6;22;28;12;22;34
109;Tomas Kopecky;FLA;R;47;15;12;27;30;12;42
110;Shane Doan;PHX;R;48;13;14;27;26;14;40
111;Mark Letestu;CBJ;C;46;13;14;27;26;14;40
112;Devin Setoguchi;MIN;R;48;13;14;27;26;14;40
113;Marian Gaborik;NYR, CBJ;R;47;12;15;27;24;15;39
114;Alex Tanguay;CGY;L;40;11;16;27;22;16;38
115;Jannik Hansen;VAN;R;47;10;17;27;20;17;37
116;Brandon Saad;CHI;L;46;10;17;27;20;17;37
117;Jiri Hudler;CGY;C;42;10;17;27;20;17;37
118;Alex Galchenyuk;MTL;C;48;9;18;27;18;18;36
119;Brian Campbell;FLA;D;48;8;19;27;24;38;62
120;Justin Schultz;EDM;D;48;8;19;27;24;38;62
121;Saku Koivu;ANA;C;47;8;19;27;16;19;35
122;Alexander Steen;STL;C;40;8;19;27;16;19;35
123;Milan Lucic;BOS;L;46;7;20;27;14;20;34
124;Matt Cullen;MIN;C;42;7;20;27;14;20;34
125;Mark Streit;NYI;D;48;6;21;27;18;42;60
126;Duncan Keith;CHI;D;47;3;24;27;9;48;57
127;Sergei Gonchar;OTT;D;45;3;24;27;9;48;57
128;Alex Goligoski;DAL;D;47;3;24;27;9;48;57
129;Curtis Glencross;CGY;L;40;15;11;26;30;11;41
130;Brian Gionta;MTL;R;48;14;12;26;28;12;40
131;Mike Green;WSH;D;35;12;14;26;36;28;64
132;Damien Brunner;DET;C;44;12;14;26;24;14;38
133;Daniel Alfredsson;OTT;R;47;10;16;26;20;16;36
134;Brayden Schenn;PHI;C;47;8;18;26;16;18;34
135;Mikkel Boedker;PHX;L;48;7;19;26;14;19;33
136;Patrik Berglund;STL;C;48;17;8;25;34;8;42
137;David Legwand;NSH;C;48;12;13;25;24;13;37
138;Brenden Morrow;DAL, PIT;L;44;12;13;25;24;13;37
139;David Perron;STL;L;48;10;15;25;20;15;35
140;Slava Voynov;LAK;D;48;6;19;25;18;38;56
141;David Clarkson;NJD;R;48;15;9;24;30;9;39
142;Alexandre Burrows;VAN;L;47;13;11;24;26;11;37
143;Jeff Skinner;CAR;C;42;13;11;24;26;11;37
144;Teemu Selanne;ANA;R;46;12;12;24;24;12;36
145;Matt Read;PHI;R;42;11;13;24;22;13;35
146;Carl Hagelin;NYR;L;48;10;14;24;20;14;34
147;Steve Ott;BUF;C;48;9;15;24;18;15;33
148;Paul Stastny;COL;C;40;9;15;24;18;15;33
149;Cody Eakin;DAL;C;48;7;17;24;14;17;31
150;Francois Beauchemin;ANA;D;48;6;18;24;18;36;54
151;Alex Pietrangelo;STL;D;47;5;19;24;15;38;53
152;Martin Erat;NSH, WSH;R;45;5;19;24;10;19;29
153;Dan Hamhuis;VAN;D;47;4;20;24;12;40;52
154;Kyle Okposo;NYI;R;48;4;20;24;8;20;28
155;Ryan Nugent-Hopkins;EDM;C;40;4;20;24;8;20;28
156;Oliver Ekman-Larsson;PHX;D;48;3;21;24;9;42;51
157;Andrew Cogliano;ANA;C;48;13;10;23;26;10;36
158;Martin Hanzal;PHX;C;39;11;12;23;22;12;34
159;Viktor Stalberg;CHI;L;47;9;14;23;18;14;32
160;Bryan Bickell;CHI;L;48;9;14;23;18;14;32
161;Nikolai Kulemin;TOR;L;48;7;16;23;14;16;30
162;Paul Martin;PIT;D;34;6;17;23;18;34;52
163;Kevin Shattenkirk;STL;D;48;5;18;23;15;36;51
164;Matt Stajan;CGY;C;43;5;18;23;10;18;28
165;Nathan Horton;BOS;R;43;13;9;22;26;9;35
166;Jussi Jokinen;CAR, PIT;L;43;13;9;22;26;9;35
167;Jamie McGinn;COL;L;47;11;11;22;22;11;33
168;Mason Raymond;VAN;L;46;10;12;22;20;12;32
169;Alexander Edler;VAN;D;45;8;14;22;24;28;52
170;Jay Bouwmeester;CGY, STL;D;47;7;15;22;21;30;51
171;Drew Doughty;LAK;D;48;6;16;22;18;32;50
172;Dennis Wideman;CGY;D;46;6;16;22;18;32;50
173;John Carlson;WSH;D;48;6;16;22;18;32;50
174;Marcus Johansson;WSH;C;34;6;16;22;12;16;28
175;Christian Ehrhoff;BUF;D;47;5;17;22;15;34;49
176;Matthew Carle;TBL;D;48;5;17;22;15;34;49
177;Fedor Tyutin;CBJ;D;48;4;18;22;12;36;48
178;Michael Grabner;NYI;R;45;16;5;21;32;5;37
179;Shawn Matthias;FLA;C;48;14;7;21;28;7;35
180;Antoine Vermette;PHX;C;48;13;8;21;26;8;34
181;Dany Heatley;MIN;L;36;11;10;21;22;10;32
182;Mike Fisher;NSH;C;38;10;11;21;20;11;31
183;Kyle Palmieri;ANA;C;42;10;11;21;20;11;31
184;Matt Cooke;PIT;L;48;8;13;21;16;13;29
185;Andy McDonald;STL;C;37;7;14;21;14;14;28
186;Michael Del Zotto;NYR;D;46;3;18;21;9;36;45
187;John Mitchell;COL;C;47;10;10;20;20;10;30
188;Ales Hemsky;EDM;R;38;9;11;20;18;11;29
189;Brent Burns;SJS;D;30;9;11;20;27;22;49
190;Brent Seabrook;CHI;D;47;8;12;20;24;24;48
191;Pierre-Marc Bouchard;MIN;C;43;8;12;20;16;12;28
192;Clarke MacArthur;TOR;L;40;8;12;20;16;12;28
193;Joel Ward;WSH;R;39;8;12;20;16;12;28
194;Benoit Pouliot;TBL;L;34;8;12;20;16;12;28
195;Dan Boyle;SJS;D;46;7;13;20;21;26;47
196;Travis Zajac;NJD;C;48;7;13;20;14;13;27
197;T.J. Oshie;STL;C;30;7;13;20;14;13;27
198;Mika Zibanejad;OTT;C;42;7;13;20;14;13;27
199;Ryan O'Reilly;COL;C;29;6;14;20;12;14;26
200;Patrick Sharp;CHI;R;28;6;14;20;12;14;26
201;David Moss;PHX;R;45;5;15;20;10;15;25
202;Victor Hedman;TBL;D;44;4;16;20;12;32;44
203;Brandon Dubinsky;CBJ;C;29;2;18;20;4;18;22
204;Brandon Sutter;PIT;C;48;11;8;19;22;8;30
205;Josh Bailey;NYI;C;38;11;8;19;22;8;30
206;Jakob Silfverberg;OTT;R;48;10;9;19;20;9;29
207;Marcel Goc;FLA;C;42;9;10;19;18;10;28
208;Vladimir Sobotka;STL;C;48;8;11;19;16;11;27
209;Colin Greening;OTT;C;47;8;11;19;16;11;27
210;Vladimir Tarasenko;STL;R;38;8;11;19;16;11;27
211;Zdeno Chara;BOS;D;48;7;12;19;21;24;45
212;Alex Killorn;TBL;C;38;7;12;19;14;12;26
213;Colin Wilson;NSH;C;25;7;12;19;14;12;26
214;Daniel Winnik;ANA;C;48;6;13;19;12;13;25
215;Nick Foligno;CBJ;L;45;6;13;19;12;13;25
216;Jack Johnson;CBJ;D;44;5;14;19;15;28;43
217;Patrick Wiercioch;OTT;D;42;5;14;19;15;28;43
218;Ryan McDonagh;NYR;D;47;4;15;19;12;30;42
219;Marek Zidlicky;NJD;D;48;4;15;19;12;30;42
220;Ryane Clowe;SJS, NYR;L;40;3;16;19;6;16;22
221;Artem Anisimov;CBJ;C;35;11;7;18;22;7;29
222;Joffrey Lupul;TOR;R;16;11;7;18;22;7;29
223;Cam Atkinson;CBJ;R;35;9;9;18;18;9;27
224;RJ Umberger;CBJ;C;48;8;10;18;16;10;26
225;Martin Havlat;SJS;R;40;8;10;18;16;10;26
226;Jarret Stoll;LAK;C;48;7;11;18;14;11;25
227;Raffi Torres;PHX, SJS;L;39;7;11;18;14;11;25
228;Nick Leddy;CHI;D;48;6;12;18;18;24;42
229;Drew Stafford;BUF;R;46;6;12;18;12;12;24
230;Rich Peverley;BOS;C;47;6;12;18;12;12;24
231;Nik Antropov;WPG;C;40;6;12;18;12;12;24
232;Roman Josi;NSH;D;48;5;13;18;15;26;41
233;Marcus Foligno;BUF;L;47;5;13;18;10;13;23
234;Daniel Paille;BOS;L;46;10;7;17;20;7;27
235;Valtteri Filppula;DET;C;41;9;8;17;18;8;26
236;Gabriel Landeskog;COL;L;36;9;8;17;18;8;26
237;Eric Fehr;WSH;R;41;9;8;17;18;8;26
238;Roman Cervenka;CGY;C;39;9;8;17;18;8;26
239;Jay McClement;TOR;C;48;8;9;17;16;9;25
240;Peter Mueller;FLA;C;43;8;9;17;16;9;25
241;Sheldon Souray;ANA;D;44;7;10;17;21;20;41
242;Steve Sullivan;PHX, NJD;L;42;7;10;17;14;10;24
243;Colin McDonald;NYI;R;45;7;10;17;14;10;24
244;Joe Corvo;CAR;D;40;6;11;17;18;22;40
245;Mathieu Perreault;WSH;C;39;6;11;17;12;11;23
246;Dennis Seidenberg;BOS;D;46;4;13;17;12;26;38
247;Vernon Fiddler;DAL;L;46;4;13;17;8;13;21
248;Sami Salo;TBL;D;46;2;15;17;6;30;36
249;Adam Henrique;NJD;C;42;11;5;16;22;5;27
250;Gabriel Bourque;NSH;L;34;11;5;16;22;5;27
251;Mikhail Grabovski;TOR;C;48;9;7;16;18;7;25
252;Matt Calvert;CBJ;L;42;9;7;16;18;7;25
253;Magnus Paajarvi;EDM;L;42;9;7;16;18;7;25
254;Jason Garrison;VAN;D;47;8;8;16;24;16;40
255;Patrick Dwyer;CAR;R;46;8;8;16;16;8;24
256;Tom Pyatt;TBL;C;43;8;8;16;16;8;24
257;Mikael Backlund;CGY;C;32;8;8;16;16;8;24
258;Jake Muzzin;LAK;D;45;7;9;16;21;18;39
259;Daniel Briere;PHI;C;34;6;10;16;12;10;22
260;Dougie Hamilton;BOS;D;42;5;11;16;15;22;37
261;Simon Gagne;LAK, PHI;L;38;5;11;16;10;11;21
262;Andy Greene;NJD;D;48;4;12;16;12;24;36
263;Grant Clitsome;WPG;D;44;4;12;16;12;24;36
264;Chris Higgins;VAN;L;41;10;5;15;20;5;25
265;Daniel Cleary;DET;R;48;9;6;15;18;6;24
266;Andrew Shaw;CHI;C;48;9;6;15;18;6;24
267;Steve Bernier;NJD;R;47;8;7;15;16;7;23
268;Nate Thompson;TBL;C;45;7;8;15;14;8;22
269;Ryan Carter;NJD;C;44;6;9;15;12;9;21
270;Kyle Wellwood;WPG;C;39;6;9;15;12;9;21
271;Casey Cizikas;NYI;C;45;6;9;15;12;9;21
272;Justin Faulk;CAR;D;38;5;10;15;15;20;35
273;Jared Spurgeon;MIN;D;39;5;10;15;15;20;35
274;Mark Giordano;CGY;D;47;4;11;15;12;22;34
275;Sean Couturier;PHI;C;46;4;11;15;8;11;19
276;Zack Smith;OTT;C;48;4;11;15;8;11;19
277;Tobias Enstrom;WPG;D;22;4;11;15;12;22;34
278;Sergei Kostitsyn;NSH;L;46;3;12;15;6;12;18
279;Scott Gomez;SJS;C;39;2;13;15;4;13;17
280;Carl Gunnarsson;TOR;D;37;1;14;15;3;28;31
281;Charlie Coyle;MIN;C;37;8;6;14;16;6;22
282;Olli Jokinen;WPG;C;45;7;7;14;14;7;21
283;Dave Bolland;CHI;C;35;7;7;14;14;7;21
284;Kyle Clifford;LAK;L;48;7;7;14;14;7;21
285;Antoine Roussel;DAL;L;39;7;7;14;14;7;21
286;Erik Karlsson;OTT;D;17;6;8;14;18;16;34
287;Chris Phillips;OTT;D;48;5;9;14;15;18;33
288;Zach Bogosian;WPG;D;33;5;9;14;15;18;33
289;Trevor Lewis;LAK;C;48;5;9;14;10;9;19
290;James Wisniewski;CBJ;D;30;5;9;14;15;18;33
291;Jochen Hecht;BUF;C;47;5;9;14;10;9;19
292;Brandon Prust;MTL;L;38;5;9;14;10;9;19
293;TJ Galiardi;SJS;L;36;5;9;14;10;9;19
294;Kyle Chipchura;PHX;C;46;5;9;14;10;9;19
295;Matt Niskanen;PIT;D;40;4;10;14;12;20;32
296;Boyd Gordon;PHX;C;48;4;10;14;8;10;18
297;Stephen Gionta;NJD;R;48;4;10;14;8;10;18
298;Milan Michalek;OTT;L;23;4;10;14;8;10;18
299;Patric Hornqvist;NSH;R;24;4;10;14;8;10;18
300;Kevin Klein;NSH;D;47;3;11;14;9;22;31
301;Lubomir Visnovsky;NYI;D;35;3;11;14;9;22;31
302;Jason Chimera;WSH;L;47;3;11;14;6;11;17
303;Beau Bennett;PIT;R;26;3;11;14;6;11;17
304;Dan Girardi;NYR;D;46;2;12;14;6;24;30
305;TJ Brodie;CGY;D;47;2;12;14;6;24;30
306;Dustin Penner;LAK;R;33;2;12;14;4;12;16
307;Raphael Diaz;MTL;D;23;1;13;14;3;26;29
308;Justin Abdelkader;DET;L;48;10;3;13;20;3;23
309;Erik Cole;MTL, DAL;L;47;9;4;13;18;4;22
310;Nick Spaling;NSH;C;47;9;4;13;18;4;22
311;Matt Beleskey;ANA;L;42;8;5;13;16;5;21
312;Jaden Schwartz;STL;C;45;7;6;13;14;6;20
313;Rene Bourque;MTL;R;27;7;6;13;14;6;20
314;Matt Frattin;TOR;R;25;7;6;13;14;6;20
315;Tommy Wingels;SJS;C;42;5;8;13;10;8;18
316;Nick Bonino;ANA;C;27;5;8;13;10;8;18
317;Trevor Daley;DAL;D;44;4;9;13;12;18;30
318;Andrew Ference;BOS;D;48;4;9;13;12;18;30
319;Jakub Kindl;DET;D;41;4;9;13;12;18;30
320;Marcus Kruger;CHI;C;47;4;9;13;8;9;17
321;Gregory Campbell;BOS;C;48;4;9;13;8;9;17
322;Ryan Whitney;EDM;D;34;4;9;13;12;18;30
323;Ruslan Fedotenko;PHI;L;47;4;9;13;8;9;17
324;Ryan Kesler;VAN;C;17;4;9;13;8;9;17
325;Jonathan Ericsson;DET;D;45;3;10;13;9;20;29
326;Tom Gilbert;MIN;D;43;3;10;13;9;20;29
327;Drew Shore;FLA;C;43;3;10;13;6;10;16
328;Ryan Smyth;EDM;L;47;2;11;13;4;11;15
329;Tyson Barrie;COL;D;32;2;11;13;6;22;28
330;Stephane Robidas;DAL;D;48;1;12;13;3;24;27
331;Ron Hainsey;WPG;D;47;0;13;13;0;26;26
332;Kyle Brodziak;MIN;C;48;8;4;12;16;4;20
333;Cody McLeod;COL;L;48;8;4;12;16;4;20
334;Andrei Loktionov;NJD;C;28;8;4;12;16;4;20
335;Shawn Horcoff;EDM;C;31;7;5;12;14;5;19
336;Kevin Bieksa;VAN;D;36;6;6;12;18;12;30
337;Matt Irwin;SJS;D;38;6;6;12;18;12;30
338;Keith Aucoin;NYI;C;41;6;6;12;12;6;18
339;Blake Comeau;CGY, CBJ;L;42;6;6;12;12;6;18
340;Ryan Johansen;CBJ;C;40;5;7;12;10;7;17
341;Eric Brewer;TBL;D;48;4;8;12;12;16;28
342;Chris Neil;OTT;R;48;4;8;12;8;8;16
343;Erik Condra;OTT;R;48;4;8;12;8;8;16
344;Craig Smith;NSH;C;44;4;8;12;8;8;16
345;Andrew MacDonald;NYI;D;48;3;9;12;9;18;27
346;Jeff Petry;EDM;D;48;3;9;12;9;18;27
347;Johnny Oduya;CHI;D;48;3;9;12;9;18;27
348;Barret Jackman;STL;D;46;3;9;12;9;18;27
349;Alexei Emelin;MTL;D;38;3;9;12;9;18;27
350;Jack Skille;FLA;R;40;3;9;12;6;9;15
351;Andrej Sekera;BUF;D;37;2;10;12;6;20;26
352;Rob Scuderi;LAK;D;48;1;11;12;3;22;25
353;Michal Rozsival;CHI;D;27;0;12;12;0;24;24
354;Scott Hartnell;PHI;L;32;8;3;11;16;3;19
355;Eric Nystrom;DAL;L;48;7;4;11;14;4;18
356;Zack Kassian;VAN;R;39;7;4;11;14;4;18
357;Taylor Pyatt;NYR;L;48;6;5;11;12;5;17
358;Lauri Korpikoski;PHX;L;36;6;5;11;12;5;17
359;Tyler Kennedy;PIT;C;46;6;5;11;12;5;17
360;Brian Flynn;BUF;C;26;6;5;11;12;5;17
361;Matt Halischuk;NSH;R;36;5;6;11;10;6;16
362;Rob Klinkhammer;PHX;C;22;5;6;11;10;6;16
363;Matt Martin;NYI;L;48;4;7;11;8;7;15
364;Milan Hejduk;COL;R;29;4;7;11;8;7;15
365;Bobby Butler;NJD, NSH;R;34;4;7;11;8;7;15
366;Luke Schenn;PHI;D;47;3;8;11;9;16;25
367;Marc Methot;OTT;D;47;2;9;11;6;18;24
368;Jonas Brodin;MIN;D;45;2;9;11;6;18;24
369;John-Michael Liles;TOR;D;32;2;9;11;6;18;24
370;Marc Staal;NYR;D;21;2;9;11;6;18;24
371;Cam Fowler;ANA;D;37;1;10;11;3;20;23
372;Derek Morris;PHX;D;39;0;11;11;0;22;22
373;Guillaume Latendresse;OTT;L;27;6;4;10;12;4;16
374;Maxime Talbot;PHI;C;35;5;5;10;10;5;15
375;Nathan Gerbe;BUF;C;42;5;5;10;10;5;15
376;Alexander Burmistrov;WPG;C;44;4;6;10;8;6;14
377;Maxim Lapierre;VAN;C;48;4;6;10;8;6;14
378;Dwight King;LAK;L;47;4;6;10;8;6;14
379;Cal Clutterbuck;MIN;R;42;4;6;10;8;6;14
380;Travis Hamonic;NYI;D;48;3;7;10;9;14;23
381;Jay Harrison;CAR;D;47;3;7;10;9;14;23
382;Dmitry Kulikov;FLA;D;34;3;7;10;9;14;23
383;Michael Frolik;CHI;R;45;3;7;10;6;7;13
384;Andre Benoit;OTT;D;33;3;7;10;9;14;23
385;TJ Brennan;BUF, FLA;D;29;3;7;10;9;14;23
386;Emerson Etem;ANA;R;38;3;7;10;6;7;13
387;Ryan Garbutt;DAL;C;36;3;7;10;6;7;13
388;Sven Baertschi;CGY;L;20;3;7;10;6;7;13
389;Niklas Hjalmarsson;CHI;D;46;2;8;10;6;16;22
390;Jordan Leopold;BUF, STL;D;39;2;8;10;6;16;22
391;Filip Kuba;FLA;D;44;1;9;10;3;18;21
392;Jan Hejda;COL;D;46;1;9;10;3;18;21
393;Clayton Stoner;MIN;D;48;0;10;10;0;20;20
394;Ben Lovejoy;PIT, ANA;D;35;0;10;10;0;20;20
395;Michael Stone;PHX;D;40;5;4;9;15;8;23
396;Chuck Kobasew;COL;R;37;5;4;9;10;4;14
397;Richard Panik;TBL;R;25;5;4;9;10;4;14
398;Leo Komarov;TOR;C;42;4;5;9;8;5;13
399;Alexei Ponikarovsky;WPG, NJD;L;42;4;5;9;8;5;13
400;Paul Postma;WPG;D;34;4;5;9;12;10;22
401;Kevin Porter;BUF;C;31;4;5;9;8;5;13
402;Rich Clune;NSH;L;47;4;5;9;8;5;13
403;Riley Nash;CAR;C;32;4;5;9;8;5;13
404;Wojtek Wolski;WSH;L;27;4;5;9;8;5;13
405;Tuomo Ruutu;CAR;R;17;4;5;9;8;5;13
406;Nikita Nikitin;CBJ;D;38;3;6;9;9;12;21
407;David Jones;COL;R;33;3;6;9;6;6;12
408;Craig Adams;PIT;R;48;3;6;9;6;6;12
409;Chris Kelly;BOS;C;34;3;6;9;6;6;12
410;Jordan Schroeder;VAN;C;31;3;6;9;6;6;12
411;Jack Hillen;WSH;D;23;3;6;9;9;12;21
412;Reilly Smith;DAL;R;37;3;6;9;6;6;12
413;Lennart Petrell;EDM;C;35;3;6;9;6;6;12
414;Derek Dorsett;CBJ;R;24;3;6;9;6;6;12
415;Josh Gorges;MTL;D;48;2;7;9;6;14;20
416;Dainius Zubrus;NJD;C;22;2;7;9;4;7;11
417;Aaron Palushaj;COL;R;25;2;7;9;4;7;11
418;Nick Schultz;EDM;D;48;1;8;9;3;16;19
419;Francis Bouillon;MTL;D;48;1;8;9;3;16;19
420;Mike Weaver;FLA;D;27;1;8;9;3;16;19
421;Joni Pitkanen;CAR;D;22;1;8;9;3;16;19
422;Steve Oleksy;WSH;D;28;1;8;9;3;16;19
423;Marc-Andre Bergeron;TBL, CAR;D;25;1;8;9;3;16;19
424;Tim Gleason;CAR;D;42;0;9;9;0;18;18
425;Ryan Malone;TBL;L;24;6;2;8;12;2;14
426;Matt Hendricks;WSH;C;48;5;3;8;10;3;13
427;Cory Emmerton;DET;C;48;5;3;8;10;3;13
428;Drew Miller;DET;L;44;4;4;8;8;4;12
429;Torrey Mitchell;MIN;C;45;4;4;8;8;4;12
430;Matthew Lombardi;PHX, ANA;C;28;4;4;8;8;4;12
431;Mike Knuble;PHI;R;28;4;4;8;8;4;12
432;Steve Begin;CGY;L;36;4;4;8;8;4;12
433;Brenden Dillon;DAL;D;48;3;5;8;9;10;19
434;Tyler Myers;BUF;D;39;3;5;8;9;10;19
435;Erik Gustafsson;PHI;D;27;3;5;8;9;10;19
436;Joakim Andersson;DET;C;38;3;5;8;6;5;11
437;Derek MacKenzie;CBJ;C;43;3;5;8;6;5;11
438;Brandon Yip;NSH;R;34;3;5;8;6;5;11
439;Jordin Tootoo;DET;R;42;3;5;8;6;5;11
440;Mats Zuccarello;NYR;C;15;3;5;8;6;5;11
441;Rostislav Klesla;PHX;D;38;2;6;8;6;12;18
442;Jay Beagle;WSH;C;48;2;6;8;4;6;10
443;Michal Handzus;SJS, CHI;C;39;2;6;8;4;6;10
444;Patrick Eaves;DET;R;34;2;6;8;4;6;10
445;Mikael Granlund;MIN;C;27;2;6;8;4;6;10
446;Chris Porter;STL;L;29;2;6;8;4;6;10
447;Luca Sbisa;ANA;D;41;1;7;8;3;14;17
448;Chris Butler;CGY;D;44;1;7;8;3;14;17
449;Jamie McBain;CAR;D;40;1;7;8;3;14;17
450;B.J. Crombeen;TBL;R;44;1;7;8;2;7;9
451;Brooks Orpik;PIT;D;46;0;8;8;0;16;16
452;Michael Kostka;TOR;D;35;0;8;8;0;16;16
453;Mark Fraser;TOR;D;45;0;8;8;0;16;16
454;Brendan Smith;DET;D;34;0;8;8;0;16;16
455;Alex Chiasson;DAL;R;7;6;1;7;12;1;13
456;Anton Stralman;NYR;D;48;4;3;7;12;6;18
457;Tomas Tatar;DET;C;18;4;3;7;8;3;11
458;Marc-Edouard Vlasic;SJS;D;48;3;4;7;9;8;17
459;Wade Redden;STL, BOS;D;29;3;4;7;9;8;17
460;Shawn Thornton;BOS;L;45;3;4;7;6;4;10
461;Taylor Beck;NSH;L;16;3;4;7;6;4;10
462;Christopher Tanev;VAN;D;38;2;5;7;6;10;16
463;Keith Aulie;TBL;D;45;2;5;7;6;10;16
464;Simon Despres;PIT;D;33;2;5;7;6;10;16
465;Davis Drewiske;LAK, MTL;D;29;2;5;7;6;10;16
466;Ryan Jones;EDM;L;27;2;5;7;4;5;9
467;Colin Fraser;LAK;C;34;2;5;7;4;5;9
468;Roman Horak;CGY;L;20;2;5;7;4;5;9
469;Mike Weber;BUF;D;42;1;6;7;3;12;15
470;Kris Russell;STL;D;33;1;6;7;3;12;15
471;Dalton Prout;CBJ;D;28;1;6;7;3;12;15
472;Jonathon Blum;NSH;D;35;1;6;7;3;12;15
473;Tomas Kundratek;WSH;D;25;1;6;7;3;12;15
474;John Moore;CBJ, NYR;D;30;1;6;7;3;12;15
475;David Steckel;TOR, ANA;C;34;1;6;7;2;6;8
476;Justin Braun;SJS;D;41;0;7;7;0;14;14
477;Victor Bartley;NSH;D;24;0;7;7;0;14;14
478;Jim O'Brien;OTT;C;29;5;1;6;10;1;11
479;Ryan Reaves;STL;R;43;4;2;6;8;2;10
480;Mark Olver;COL;C;32;4;2;6;8;2;10
481;Nick Johnson;PHX;R;17;4;2;6;8;2;10
482;John Erskine;WSH;D;30;3;3;6;9;6;15
483;Jerred Smithson;FLA, EDM;R;45;3;3;6;6;3;9
484;Dale Weise;VAN;R;40;3;3;6;6;3;9
485;Matt D'Agostini;STL, NJD;R;29;3;3;6;6;3;9
486;Gustav Nyquist;DET;C;22;3;3;6;6;3;9
487;Dustin Jeffrey;PIT;C;24;3;3;6;6;3;9
488;Tyler Johnson;TBL;C;14;3;3;6;6;3;9
489;Ryan O'Byrne;COL, TOR;D;42;2;4;6;6;8;14
490;Eric Gryba;OTT;D;33;2;4;6;6;8;14
491;Bobby Sanguinetti;CAR;D;37;2;4;6;6;8;14
492;Travis Moen;MTL;L;45;2;4;6;4;4;8
493;Ryan Ellis;NSH;D;32;2;4;6;6;8;14
494;Jordan Nolan;LAK;C;44;2;4;6;4;4;8
495;Jared Boll;CBJ;R;43;2;4;6;4;4;8
496;Adam Cracknell;STL;R;20;2;4;6;4;4;8
497;Ville Leino;BUF;L;8;2;4;6;4;4;8
498;Johnny Boychuk;BOS;D;44;1;5;6;3;10;13
499;Roman Polak;STL;D;48;1;5;6;3;10;13
500;Douglas Murray;SJS, PIT;D;43;1;5;6;3;10;13
501;Bruno Gervais;PHI;D;37;1;5;6;3;10;13
502;Mark Fayne;NJD;D;31;1;5;6;3;10;13
503;David Schlemko;PHX;D;30;1;5;6;3;10;13
504;Jordie Benn;DAL;D;26;1;5;6;3;10;13
505;Andrew Ebbett;VAN;C;28;1;5;6;2;5;7
506;Brad Richardson;LAK;R;16;1;5;6;2;5;7
507;Brad Stuart;SJS;D;48;0;6;6;0;12;12
508;Matt Hunwick;COL;D;43;0;6;6;0;12;12
509;Greg Zanon;COL;D;44;0;6;6;0;12;12
510;Bryan Allen;ANA;D;41;0;6;6;0;12;12
511;Toni Lydman;ANA;D;35;0;6;6;0;12;12
512;Adam Larsson;NJD;D;37;0;6;6;0;12;12
513;Deryk Engelland;PIT;D;42;0;6;6;0;12;12
514;Mark Fistric;EDM;D;25;0;6;6;0;12;12
515;Paul Bissonnette;PHX;L;28;0;6;6;0;6;6
516;Scottie Upshall;FLA;R;27;4;1;5;8;1;9
517;Jason Zucker;MIN;L;20;4;1;5;8;1;9
518;Drayson Bowman;CAR;L;37;3;2;5;6;2;8
519;Antti Miettinen;WPG;R;22;3;2;5;6;2;8
520;Zac Rinaldo;PHI;C;32;3;2;5;6;2;8
521;Peter Holland;ANA;C;21;3;2;5;6;2;8
522;Tye McGinn;PHI;L;18;3;2;5;6;2;8
523;Frazer McLaren;SJS, TOR;L;36;3;2;5;6;2;8
524;Brian Boyle;NYR;C;38;2;3;5;4;3;7
525;Philip Larsen;DAL;D;32;2;3;5;6;6;12
526;James Wright;WPG;C;38;2;3;5;4;3;7
527;Colby Armstrong;MTL;R;37;2;3;5;4;3;7
528;Peter Harrold;NJD;D;23;2;3;5;6;6;12
529;Radko Gudas;TBL;D;22;2;3;5;6;6;12
530;Paul Gaustad;NSH;C;23;2;3;5;4;3;7
531;Joe Vitale;PIT;C;33;2;3;5;4;3;7
532;Patrick Bordeleau;COL;L;46;2;3;5;4;3;7
533;Alex Kovalev;FLA;R;14;2;3;5;4;3;7
534;Chris Mueller;NSH;C;18;2;3;5;4;3;7
535;David Ullstrom;NYI;L;20;2;3;5;4;3;7
536;Tyler Toffoli;LAK;C;10;2;3;5;4;3;7
537;Jason Spezza;OTT;C;5;2;3;5;4;3;7
538;Karl Alzner;WSH;D;48;1;4;5;3;8;11
539;Braydon Coburn;PHI;D;33;1;4;5;3;8;11
540;Anton Volchenkov;NJD;D;37;1;4;5;3;8;11
541;Brian Lashoff;DET;D;31;1;4;5;3;8;11
542;Alec Martinez;LAK;D;27;1;4;5;3;8;11
543;Tim Jackman;CGY;R;42;1;4;5;2;4;6
544;Mark Pysyk;BUF;D;19;1;4;5;3;8;11
545;Kurtis Foster;PHI;D;23;1;4;5;3;8;11
546;Mikhail Grigorenko;BUF;C;25;1;4;5;2;4;6
547;Tim Erixon;CBJ;D;31;0;5;5;0;10;10
548;Aaron Rome;DAL;D;27;0;5;5;0;10;10
549;Marty Reasoner;NYI;C;31;0;5;5;0;5;5
550;Radek Dvorak;ANA;R;9;4;0;4;8;0;8
551;Corey Potter;EDM;D;33;3;1;4;9;2;11
552;Alexander Sulzer;BUF;D;17;3;1;4;9;2;11
553;Mark Stuart;WPG;D;42;2;2;4;6;4;10
554;Ian White;DET;D;25;2;2;4;6;4;10
555;Chad LaRose;CAR;R;35;2;2;4;4;2;6
556;Mike Santorelli;FLA, WPG;C;34;2;2;4;4;2;6
557;J.T. Miller;NYR;C;26;2;2;4;4;2;6
558;Chris Thorburn;WPG;R;42;2;2;4;4;2;6
559;Robert Bortuzzo;PIT;D;15;2;2;4;6;4;10
560;Kevin Westgarth;CAR;R;31;2;2;4;4;2;6
561;Kris Versteeg;FLA;R;10;2;2;4;4;2;6
562;Ondrej Palat;TBL;L;14;2;2;4;4;2;6
563;Tomas Vincour;DAL, COL;C;17;2;2;4;4;2;6
564;Jean-Gabriel Pageau;OTT;C;9;2;2;4;4;2;6
565;Ladislav Smid;EDM;D;48;1;3;4;3;6;9
566;Thomas Hickey;NYI;D;39;1;3;4;3;6;9
567;Nicklas Grossmann;PHI;D;30;1;3;4;3;6;9
568;Adam McQuaid;BOS;D;32;1;3;4;3;6;9
569;Henrik Tallinder;NJD;D;25;1;3;4;3;6;9
570;Eric Tangradi;PIT, WPG;C;41;1;3;4;2;3;5
571;James Sheppard;SJS;C;32;1;3;4;2;3;5
572;Mike Rupp;NYR, MIN;C;40;1;3;4;2;3;5
573;Stefan Elliott;COL;D;18;1;3;4;3;6;9
574;Stephen Weiss;FLA;C;17;1;3;4;2;3;5
575;Colton Orr;TOR;R;44;1;3;4;2;3;5
576;Kaspars Daugavins;OTT, BOS;L;25;1;3;4;2;3;5
577;Dana Tyrell;TBL;C;21;1;3;4;2;3;5
578;Chris Bourque;BOS;L;18;1;3;4;2;3;5
579;Zach Redmond;WPG;D;8;1;3;4;3;6;9
580;Brooks Laich;WSH;C;9;1;3;4;2;3;5
581;Jimmy Hayes;CHI;R;10;1;3;4;2;3;5
582;Robyn Regehr;BUF, LAK;D;41;0;4;4;0;8;8
583;Tyson Strachan;FLA;D;38;0;4;4;0;8;8
584;Erik Johnson;COL;D;31;0;4;4;0;8;8
585;Erik Gudbranson;FLA;D;32;0;4;4;0;8;8
586;Adrian Aucoin;CBJ;D;36;0;4;4;0;8;8
587;Shane O'Brien;COL;D;28;0;4;4;0;8;8
588;Adam Hall;TBL, CAR, PHI;R;37;0;4;4;0;4;4
589;Brian Strait;NYI;D;19;0;4;4;0;8;8
590;Adam Pardy;BUF;D;17;0;4;4;0;8;8
591;Jake Gardiner;TOR;D;12;0;4;4;0;8;8
592;Radek Martinek;NYI;D;13;3;0;3;9;0;9
593;Tom Sestito;PHI, VAN;L;30;3;0;3;6;0;6
594;Brian McGrattan;NSH, CGY;R;21;3;0;3;6;0;6
595;Aaron Gagnon;WPG;C;10;3;0;3;6;0;6
596;Andrew Desjardins;SJS;C;42;2;1;3;4;1;5
597;Korbinian Holzer;TOR;D;22;2;1;3;6;2;8
598;Chris Kreider;NYR;C;23;2;1;3;4;1;5
599;Oliver Lauridsen;PHI;D;15;2;1;3;6;2;8
600;Daniel Carcillo;CHI;L;23;2;1;3;4;1;5
601;Pierre-Cedric Labrie;TBL;L;19;2;1;3;4;1;5
602;Patrick Maroon;ANA;L;13;2;1;3;4;1;5
603;Todd Bertuzzi;DET;R;7;2;1;3;4;1;5
604;Kyle Quincey;DET;D;36;1;2;3;3;4;7
605;Adam Burish;SJS;R;46;1;2;3;2;2;4
606;Jeff Halpern;NYR, MTL;C;46;1;2;3;2;2;4
607;Jason Demers;SJS;D;22;1;2;3;3;4;7
608;Jacob Josefson;NJD;C;22;1;2;3;2;2;4
609;Teemu Hartikainen;EDM;C;23;1;2;3;2;2;4
610;Jordan Caron;BOS;R;17;1;2;3;2;2;4
611;Maxwell Reinhart;CGY;C;11;1;2;3;2;2;4
612;Stefan Matteau;NJD;C;17;1;2;3;2;2;4
613;David Booth;VAN;L;12;1;2;3;2;2;4
614;Matt Fraser;DAL;R;12;1;2;3;2;2;4
615;Zac Dalpe;CAR;C;10;1;2;3;2;2;4
616;Gabriel Dumont;MTL;C;10;1;2;3;2;2;4
617;Mark Cundari;CGY;D;4;1;2;3;3;4;7
618;Keaton Ellerby;FLA, LAK;D;44;0;3;3;0;6;6
619;Justin Falk;MIN;D;36;0;3;3;0;6;6
620;Steve Eminger;NYR;D;35;0;3;3;0;6;6
621;Jeff Schultz;WSH;D;26;0;3;3;0;6;6
622;Eric Belanger;EDM;C;26;0;3;3;0;3;3
623;Peter Regin;OTT;C;27;0;3;3;0;3;3
624;Tim Brent;CAR;C;30;0;3;3;0;3;3
625;Ryan Wilson;COL;D;12;0;3;3;0;6;6
626;Tomas Kaberle;MTL;D;10;0;3;3;0;6;6
627;Joey Crabb;WSH;R;26;2;0;2;4;0;4
628;Arron Asham;NYR;R;27;2;0;2;4;0;4
629;Tim Kennedy;SJS;L;13;2;0;2;4;0;4
630;Dave Dziurzynski;OTT;L;12;2;0;2;4;0;4
631;Sami Vatanen;ANA;D;8;2;0;2;6;0;6
632;Lane MacDermid;BOS, DAL;L;9;2;0;2;4;0;4
633;Tanner Glass;PIT;L;48;1;1;2;2;1;3
634;Mike Brown;TOR, EDM;R;39;1;1;2;2;1;3
635;Tim Wallace;CAR;R;28;1;1;2;2;1;3
636;Aaron Volpatti;VAN, WSH;L;33;1;1;2;2;1;3
637;Jim Slater;WPG;C;26;1;1;2;2;1;3
638;George Parros;FLA;R;39;1;1;2;2;1;3
639;Colton Gillies;CBJ;C;27;1;1;2;2;1;3
640;Zach Boychuk;CAR, PIT, NSH;L;13;1;1;2;2;1;3
641;Chris Conner;PHX;R;12;1;1;2;2;1;3
642;Ben Eager;EDM;L;14;1;1;2;2;1;3
643;Brad Malone;COL;C;13;1;1;2;2;1;3
644;Stephane Da Costa;OTT;C;9;1;1;2;2;1;3
645;Brad Staubitz;ANA;R;15;1;1;2;2;1;3
646;Jeremy Morin;CHI;L;3;1;1;2;2;1;3
647;Anders Lee;NYI;C;2;1;1;2;2;1;3
648;Bryce Salvador;NJD;D;39;0;2;2;0;4;4
649;Zbynek Michalek;PHX;D;34;0;2;2;0;4;4
650;Keith Ballard;VAN;D;36;0;2;2;0;4;4
651;Cory Sarich;CGY;D;28;0;2;2;0;4;4
652;Matt Carkner;NYI;D;22;0;2;2;0;4;4
653;Tom Poti;WSH;D;16;0;2;2;0;4;4
654;Jamie Oleksiak;DAL;D;16;0;2;2;0;4;4
655;Andrej Meszaros;PHI;D;11;0;2;2;0;4;4
656;Cam Barker;VAN;D;14;0;2;2;0;4;4
657;Matt Bartkowski;BOS;D;11;0;2;2;0;4;4
658;Jamal Mayers;CHI;R;19;0;2;2;0;2;2
659;Brett Bellemore;CAR;D;8;0;2;2;0;4;4
660;Ryan Hamilton;TOR;L;10;0;2;2;0;2;2
661;Daniel Bang;NSH;L;8;0;2;2;0;2;2
662;Jarred Tinordi;MTL;D;8;0;2;2;0;4;4
663;Nathan Beaulieu;MTL;D;6;0;2;2;0;4;4
664;Brandon Manning;PHI;D;6;0;2;2;0;4;4
665;Carl Soderberg;BOS;C;6;0;2;2;0;2;2
666;David Van Der Gulik;COL;L;9;0;2;2;0;2;2
667;Yannick Weber;MTL;D;6;0;2;2;0;4;4
668;Jesse Joensuu;NYI;L;7;0;2;2;0;2;2
669;Matt Tennyson;SJS;D;4;0;2;2;0;4;4
670;Anthony Peluso;WPG;R;5;0;2;2;0;2;2
671;Patrick Kaleta;BUF;R;34;1;0;1;2;0;2
672;Sheldon Brookbank;CHI;D;26;1;0;1;3;0;3
673;Scott Nichol;STL;C;30;1;0;1;2;0;2
674;Ryan White;MTL;C;26;1;0;1;2;0;2
675;Nick Bjugstad;FLA;C;11;1;0;1;2;0;2
676;Cody Goloubef;CBJ;D;11;1;0;1;3;0;3
677;Tom Wandell;DAL;C;18;1;0;1;2;0;2
678;Jared Cowen;OTT;D;7;1;0;1;3;0;3
679;Tom Kostopoulos;NJD;R;15;1;0;1;2;0;2
680;Matt Kassian;OTT;L;15;1;0;1;2;0;2
681;Greg Rallo;FLA;C;10;1;0;1;2;0;2
682;Marco Scandella;MIN;D;6;1;0;1;3;0;3
683;Austin Watson;NSH;L;6;1;0;1;2;0;2
684;Jay Rosehill;PHI;L;11;1;0;1;2;0;2
685;Ben Hanowski;CGY;L;5;1;0;1;2;0;2
686;Kevin Henderson;NSH;L;4;1;0;1;2;0;2
687;Brett Connolly;TBL;R;5;1;0;1;2;0;2
688;Luke Adam;BUF;C;4;1;0;1;2;0;2
689;Chris Terry;CAR;L;3;1;0;1;2;0;2
690;Ben Smith;CHI;R;1;1;0;1;2;0;2
691;Jason Akeson;PHI;R;1;1;0;1;2;0;2
692;Scott Hannan;NSH, SJS;D;33;0;1;1;0;2;2
693;Andrew Alberts;VAN;D;24;0;1;1;0;2;2
694;Kent Huskins;DET, PHI;D;19;0;1;1;0;2;2
695;Derek Smith;CGY;D;22;0;1;1;0;2;2
696;Ian Cole;STL;D;15;0;1;1;0;2;2
697;Colby Robak;FLA;D;16;0;1;1;0;2;2
698;Derek Meech;WPG;D;16;0;1;1;0;2;2
699;Danny DeKeyser;DET;D;11;0;1;1;0;2;2
700;Joe Finley;NYI;D;16;0;1;1;0;2;2
701;Roman Hamrlik;WSH, NYR;D;16;0;1;1;0;2;2
702;Mike Lundin;OTT;D;11;0;1;1;0;2;2
703;Blair Jones;CGY;C;15;0;1;1;0;1;1
704;Anton Lander;EDM;C;11;0;1;1;0;1;1
705;Carlo Colaiacovo;DET;D;6;0;1;1;0;2;2
706;Brett Clark;MIN;D;8;0;1;1;0;2;2
707;David Rundblad;PHX;D;8;0;1;1;0;2;2
708;Brett Carson;CGY;D;10;0;1;1;0;2;2
709;Ed Jovanovski;FLA;D;6;0;1;1;0;2;2
710;Anton Babchuk;CGY;D;7;0;1;1;0;2;2
711;Ben Street;CGY;C;6;0;1;1;0;1;1
712;Filip Forsberg;NSH;C;5;0;1;1;0;1;1
713;Matt Greene;LAK;D;5;0;1;1;0;2;2
714;Dmitry Orlov;WSH;D;5;0;1;1;0;2;2
715;Andreas Nodl;CAR;R;8;0;1;1;0;1;1
716;Brandon McMillan;ANA;C;6;0;1;1;0;1;1
717;Harry Zolnierczyk;PHI;L;7;0;1;1;0;1;1
718;Mikael Samuelsson;DET;R;4;0;1;1;0;1;1
719;Kris Newbury;NYR;C;6;0;1;1;0;1;1
720;Paul Byron;CGY;C;4;0;1;1;0;1;1
721;Jamie Langenbrunner;STL;R;4;0;1;1;0;1;1
722;Brendan Mikkelson;TBL;D;4;0;1;1;0;2;2
723;Benn Ferriero;NYR;R;4;0;1;1;0;1;1
724;Mattias Tedenby;NJD;L;4;0;1;1;0;1;1
725;Jeremy Welsh;CAR;C;5;0;1;1;0;1;1
726;Steve Downie;COL;R;2;0;1;1;0;1;1
727;Joonas Rask;NSH;C;2;0;1;1;0;1;1
728;Eric Selleck;FLA;L;2;0;1;1;0;1;1
729;Torey Krug;BOS;D;1;0;1;1;0;2;2
730;Matt Anderson;NJD;C;2;0;1;1;0;1;1
731;Colton Sceviour;DAL;C;1;0;1;1;0;1;1
732;Hal Gill;NSH;D;32;0;0;0;0;0;0
733;Mark Eaton;PIT;D;23;0;0;0;0;0;0
734;Darroll Powe;MIN, NYR;C;42;0;0;0;0;0;0
735;Zenon Konopka;MIN;C;37;0;0;0;0;0;0
736;Brian Lee;TBL;D;22;0;0;0;0;0;0
737;Brandon Bollig;CHI;L;25;0;0;0;0;0;0
738;Nate Prosser;MIN;D;17;0;0;0;0;0;0
739;Quinton Howden;FLA;C;18;0;0;0;0;0;0
740;John Scott;BUF;L;34;0;0;0;0;0;0
741;Jay Pandolfo;BOS;L;18;0;0;0;0;0;0
742;Aaron Johnson;BOS;D;10;0;0;0;0;0;0
743;Matt Gilroy;NYR;D;15;0;0;0;0;0;0
744;Krystofer Barch;NJD;R;22;0;0;0;0;0;0
745;Steven Pinizzotto;VAN;R;12;0;0;0;0;0;0
746;Alex Petrovic;FLA;D;6;0;0;0;0;0;0
747;Alexandre Bolduc;PHX;C;14;0;0;0;0;0;0
748;Manny Malhotra;VAN;C;9;0;0;0;0;0;0
749;Chad Ruhwedel;BUF;D;7;0;0;0;0;0;0
750;Stu Bickel;NYR;D;16;0;0;0;0;0;0
751;Eric Boulton;NYI;L;15;0;0;0;0;0;0
752;Ryan Murphy;CAR;D;4;0;0;0;0;0;0
753;Nick Drazenovic;CBJ;C;8;0;0;0;0;0;0
754;Nicolas Blanchard;CAR;C;9;0;0;0;0;0;0
755;Mark Borowiecki;OTT;D;6;0;0;0;0;0;0
756;Chris VandeVelde;EDM;C;11;0;0;0;0;0;0
757;Chris Summers;PHX;D;6;0;0;0;0;0;0
758;Theo Peckham;EDM;D;4;0;0;0;0;0;0
759;Nolan Yonkman;FLA;D;7;0;0;0;0;0;0
760;Andreas Lilja;PHI;D;4;0;0;0;0;0;0
761;Devante Smith-Pelly;ANA;R;7;0;0;0;0;0;0
762;Sean Collins;CBJ;C;5;0;0;0;0;0;0
763;Michael Sgarbossa;COL;C;6;0;0;0;0;0;0
764;Mike Komisarek;TOR;D;4;0;0;0;0;0;0
765;Micheal Haley;NYR;C;9;0;0;0;0;0;0
766;Frank Corrado;VAN;D;3;0;0;0;0;0;0
767;Scott Laughton;PHI;L;5;0;0;0;0;0;0
768;Akim Aliu;CGY;R;5;0;0;0;0;0;0
769;Michal Jordan;CAR;D;5;0;0;0;0;0;0
770;Scott Timmins;FLA;C;5;0;0;0;0;0;0
771;Jonathan Rheault;FLA;R;5;0;0;0;0;0;0
772;David Savard;CBJ;D;4;0;0;0;0;0;0
773;Cody McCormick;BUF;C;8;0;0;0;0;0;0
774;Andrew Gordon;VAN;R;6;0;0;0;0;0;0
775;Tim Sestito;NJD;C;6;0;0;0;0;0;0
776;Mark Scheifele;WPG;C;4;0;0;0;0;0;0
777;Dylan Reese;PIT;D;3;0;0;0;0;0;0
778;Joe Colborne;TOR;C;5;0;0;0;0;0;0
779;Derek Grant;OTT;C;5;0;0;0;0;0;0
780;Mike Blunden;MTL;R;5;0;0;0;0;0;0
781;Mark Stone;OTT;R;4;0;0;0;0;0;0
782;Patrice Cormier;WPG;C;10;0;0;0;0;0;0
783;Chris Brown;PHX;C;5;0;0;0;0;0;0
784;Eric Wellwood;PHI;L;4;0;0;0;0;0;0
785;Matt Ellis;BUF;L;6;0;0;0;0;0;0
786;Mike Hoffman;OTT;C;3;0;0;0;0;0;0
787;Harri Pesonen;NJD;C;4;0;0;0;0;0;0
788;Ryan Spooner;BOS;C;4;0;0;0;0;0;0
789;Rickard Rakell;ANA;R;4;0;0;0;0;0;0
790;Jordan Hendry;ANA;D;2;0;0;0;0;0;0
791;Derek Joslin;VAN;D;2;0;0;0;0;0;0
792;Matt Taormina;TBL;D;2;0;0;0;0;0;0
793;Matthew Konan;PHI;D;2;0;0;0;0;0;0
794;Mark Barberio;TBL;D;2;0;0;0;0;0;0
795;Carter Bancks;CGY;C;2;0;0;0;0;0;0
796;Greg Pateryn;MTL;D;3;0;0;0;0;0;0
797;Nicklas Jensen;VAN;L;2;0;0;0;0;0;0
798;Jared Staal;CAR;R;2;0;0;0;0;0;0
799;Drew LeBlanc;CHI;C;2;0;0;0;0;0;0
800;Brett Sutter;CAR;L;3;0;0;0;0;0;0
801;Brandon Mashinter;NYR;L;4;0;0;0;0;0;0
802;Jonathan Audy-Marchessault;CBJ;C;2;0;0;0;0;0;0
803;Andrej Sustr;TBL;D;2;0;0;0;0;0;0
804;Mark Arcobello;EDM;R;1;0;0;0;0;0;0
805;Matt Pelech;SJS;R;2;0;0;0;0;0;0
806;Brandon Pirri;CHI;C;1;0;0;0;0;0;0
807;Nick Holden;CBJ;D;2;0;0;0;0;0;0
808;Jake Dowell;MIN;C;2;0;0;0;0;0;0
809;Ryan Stanton;CHI;D;1;0;0;0;0;0;0
810;Mattias Ekholm;NSH;D;1;0;0;0;0;0;0
811;Eric Gelinas;NJD;D;1;0;0;0;0;0;0
812;Cam Janssen;NJD;R;4;0;0;0;0;0;0
813;Michael Caruso;FLA;D;2;0;0;0;0;0;0
814;Dmitrij Jaskin;STL;R;2;0;0;0;0;0;0
815;Shawn Lalonde;CHI;D;1;0;0;0;0;0;0
816;Alexander Urbom;NJD;D;1;0;0;0;0;0;0
817;Mathieu Roy;TBL;D;1;0;0;0;0;0;0
818;Johan Larsson;MIN;L;1;0;0;0;0;0;0
819;JT Wyman;TBL;R;1;0;0;0;0;0;0
820;Christian Thomas;NYR;L;1;0;0;0;0;0;0
821;Darren Helm;DET;C;1;0;0;0;0;0;0
822;Bill Sweatt;VAN;L;1;0;0;0;0;0;0
823;Bracken Kearns;SJS;C;1;0;0;0;0;0;0
824;Cameron Schilling;WSH;D;1;0;0;0;0;0;0
825;Nick Petrecki;SJS;D;1;0;0;0;0;0;0
826;Jan Mursak;DET;L;2;0;0;0;0;0;0
827;Trevor Smith;PIT;C;1;0;0;0;0;0;0
828;Jamie Tardif;BOS;R;2;0;0;0;0;0;0
829;Andy Miele;PHX;C;1;0;0;0;0;0;0
830;Darcy Hordichuk;EDM;L;4;0;0;0;0;0;0
831;Jody Shelley;PHI;L;1;0;0;0;0;0;0
832;Marc-Andre Gragnani;CAR;D;1;0;0;0;0;0;0
833;Andrew Murray;STL;C;1;0;0;0;0;0;0
834;Mike Angelidis;TBL;L;1;0;0;0;0;0;0
835;Riley Sheahan;DET;C;1;0;0;0;0;0;0
836;Toby Petersen;DAL;C;1;0;0;0;0;0;0
837;Francis Wathier;DAL;L;1;0;0;0;0;0;0
838;Brandon Segal;NYR;R;1;0;0;0;0;0;0
839;Steve MacIntyre;PIT;L;1;0;0;0;0;0;0
